Instance;Seed;Cost;Fractionality;Rounds;LPtime(ms);ZItime(ms);LP+ZItime(ms);Gap(%)
10teams;37029;917;36.681642;1;33;0;33;100
22433;37029;21552.708079;24.962328;5;6;0;6;100
23588;37029;8342.863244;17.617619;4;3;0;3;100
2club200v15p5scn;37029;-96.055556;38.611111;7;116;3;119;100
30n20b8;37029;5530;15.589981;2;104;0;104;100
30_70_45_05_100;37029;112;0;6;797;4;801;100
30_70_45_095_100;37029;59;0;6;892;2;894;100
30_70_45_095_98;37029;438;0;7;892;3;895;100
50v-10;37029;1493601.476062;0;2;4;0;4;100
a1c1s1;37029;20912.873333;0.041667;2;35;0;35;100
a2c1s1;37029;20866.0825;0;2;36;0;36;91.62
ab51-40-100;37029;-6525415131;0;3;896;1;897;37.38
ab67-40-100;37029;-7141459514;0;3;2458;1;2459;36.16
ab69-40-100;37029;-7136789852.99999;0;3;2112;1;2113;36.2
ab71-20-100;37029;-6524437227;0;3;234;0;234;37.39
ab72-40-100;37029;-7018756084.00001;0;3;797;1;798;37.26
academictimetablebig;37029;57;2027.119953;2;3238;7;3245;100
academictimetablesmall;37029;0;327.222248;2;238;1;239;100
acc-tight2;37029;0;129.034401;1;39;0;39;100
acc-tight4;37029;0;133.878393;1;61;0;61;100
acc-tight5;37029;0;121.269585;1;257;0;257;100
acc-tight6;37029;0;120.058761;1;241;0;241;100
adult-max5features;37029;0.081316;0.266955;1;921;2;923;100
adult-regularized;37029;0.077684;0.234052;1;2057;1;2058;100
aflow30a;37029;983.167425;6.510845;1;5;0;5;100
aflow40b;37029;1005.664817;8.247724;1;21;0;21;100
air03;37029;338864.25;11.875;1;59;0;59;100
air04;37029;55535.436388;52.288553;1;222;0;222;100
air05;37029;25877.609268;46.215654;1;146;0;146;100
aligninq;37029;2755;40.921868;7;14;0;14;100
allcolor10;37029;6;755.781169;2;146;1;147;100
allcolor58;37029;42;3660.566767;1;1236;3;1239;100
amaze22012-03-15i;37029;0;0;1;47;1;48;0
amaze22012-06-28i;37029;0;0;1;23;0;23;0
amaze22012-07-04i;37029;0;0;1;25;0;25;0
app1-1;37029;-2;0.179678;3;60;0;60;100
app1-2;37029;-23;1e-06;2;4237;0;4237;100
app2-1;37029;19298.5;0;2;33;0;33;0.02
app2-2;37029;219402.5;0;3;1;0;1;3.47
app3;37029;5627412.287938;3.142492;1;43;0;43;100
arki001;37029;7579599.807787;17.164714;1;32;0;32;100
assign1-10-4;37029;353.992926;52;1;36;0;36;100
assign1-5-8;37029;183.362555;24;1;3;0;3;100
atlanta-ip;37029;81.243206;325.689509;3;4370;3;4373;100
atm20-100;37029;2141734.684878;124.301066;2;86;0;86;100
australia-abs-cta;37029;0;38.750723;1;95;0;95;100
b-ball;37029;-1.818182;4.818182;1;0;0;0;100
b1c1s1;37029;69966.45;0;2;32;0;32;100
b2c1s1;37029;70651.01;0;2;33;0;33;100
bab1;37029;-286923.824223;50.52;1;261;1;262;100
bab2;37029;-353606.266494;534.575488;2;8534;5;8539;100
bab3;37029;-557391.946196;518.63538;2;30685;12;30697;100
bab5;37029;-111176.514726;175.63525;2;529;0;529;100
bab6;37029;-224575.783183;661.616846;2;5905;3;5908;100
bc;37029;13.063318;0.063318;2;110;0;110;100
bc1;37029;6.45558;0.016336;2;97;0;97;100
beasleyC1;37029;102;0;2;2;0;2;20
beasleyC2;37029;232;0;2;2;0;2;61.11
beasleyC3;37029;958;0;2;3;0;3;27.06
beavma;37029;407840.4;0;3;1;0;1;6.41
berlin;37029;1741;0;2;25;0;25;66.76
berlin_5_8_0;37029;52;64.959947;3;5;0;5;100
bg512142;37029;323992.007013;52.989642;3;30;0;30;100
biella1;37029;3060037.430763;98.771008;1;250;0;250;100
bienst1;37029;11.724138;4.390524;1;2;0;2;100
bienst2;37029;11.724138;5.390524;1;2;0;2;100
binkar10_1;37029;6637.188027;9.084811;1;7;0;7;100
blend2;37029;7.489992;0.492283;2;1;0;1;100
bley_xl1;37029;265.571332;336.926676;6;21568;4;21572;100
bley_xs1;37029;213538830.272187;107.27048;3;143;0;143;100
bley_xs1noM;37029;260783449.512445;78.38821;8;118;0;118;100
bley_xs2;37029;48593009.277766;66.02141;2;21;0;21;100
blp-ar98;37029;14303.194003;9.189386;9;98;1;99;100
blp-ic97;37029;6123.238237;3.473359;16;79;1;80;100
blp-ic98;37029;14141.050706;0.1;4;147;0;147;100
blp-ir98;37029;5639.818879;2.497817;2;41;0;41;100
bmocbd;37029;-32041010095048.5;0;1;806;6;812;0
bmocbd2;37029;-31953009810558.2;0;1;703;6;709;0
bmocbd3;37029;45423160355.8155;0;3;16515;15;16530;100
bmoipr2;37029;-46628940.711141;0.160693;3;85;0;85;100
bnatt350;37029;0;91.914943;4;81;0;81;100
bnatt400;37029;0;98.918149;7;69;0;69;100
bppc4-08;37029;51.59;8.850948;1;20;0;20;100
bppc6-02;37029;108.34;11.886994;1;143;0;143;100
bppc6-06;37029;200.633333;14.947367;1;140;0;140;100
bppc8-02;37029;486.5;3.204377;1;3;0;3;100
bppc8-09;37029;444.436047;5.98123;1;6;0;6;100
brasil;37029;31819;0;2;27;0;27;100
brazil3;37029;2;656.675844;1;1020;0;1020;100
breastcancer-regularized;37029;0.00046;0.002809;1;8;0;8;100
bts4-cta;37029;33524.637606;1130;1;594;0;594;100
buildingenergy;37029;33246.215059;1468.85;2;16196;2;16198;100
cap6000;37029;-2444651;0;3;41;0;41;0.27
cbs-cta;37029;0;28.754656;1;117;0;117;100
cdc7-4-3-2;37029;-232;0;3;36759;4;36763;19.44
chromaticindex1024-7;37029;4;16002.682953;2;2499;9;2508;100
chromaticindex128-5;37029;4;2021.163699;2;139;1;140;100
chromaticindex256-8;37029;4;4069.477083;2;393;2;395;100
chromaticindex32-8;37029;4;504.8875;2;19;0;19;100
chromaticindex512-7;37029;4;8183.527137;2;1205;4;1209;100
ci-s4;37029;4.963809;19.526141;2;72;0;72;100
circ10-3;37029;140;154.207692;1;185;0;185;100
cmflsp40-24-10-7;37029;52605868.952858;70.70093;3;381;0;381;100
cmflsp40-36-2-10;37029;72898024.959478;295.649246;3;897;0;897;100
cmflsp50-24-10-4;37029;64492612.641644;81.236085;3;423;0;423;100
cmflsp50-24-8-8;37029;59814378.749021;131.86946;3;411;0;411;100
cmflsp60-36-2-6;37029;97887903.946142;370.689759;3;1861;0;1861;100
CMS750_4;37029;250;258.046726;3;125;0;125;100
co-100;37029;1250429.774879;9.799423;2;290;1;291;100
cod105;37029;-8;0;3;483;1;484;33.33
comp07-2idx;37029;0;139.65;2;1543;0;1543;100
comp08-2idx;37029;0;183.178592;3;269;0;269;100
comp12-2idx;37029;16;249.122949;3;1488;1;1489;100
comp16-3idx;37029;4;722.299516;1;8652;1;8653;100
comp21-2idx;37029;0;197.95;2;925;0;925;100
control30-3-2-3;37029;-20763026.787568;27.97054;1;5;0;5;100
core2536-691;37029;788;0;3;1370;2;1372;14.37
core2586-950;37029;1150;0;3;843;2;845;21.31
core4284-1064;37029;1320;0;3;5009;4;5013;24.18
core4872-1529;37029;1863;0;3;2836;5;2841;21.76
cost266-UUE;37029;42001606.28;0;2;80;0;80;67.01
cov1075;37029;56;0;3;5;0;5;100
cryptanalysiskb128n5obj16;37029;0;7174.215397;2;917;5;922;100
csched007;37029;269.251587;22.185714;1;38;0;38;100
csched008;37029;171;19.809478;1;11;0;11;100
csched010;37029;332.422727;20.035354;1;34;0;34;100
cvrpa-n64k9vrpi;37029;0;211.276596;1;341;1;342;100
cvrpb-n45k5vrpi;37029;0;153.312977;1;574;0;574;100
cvrpp-n16k8vrpi;37029;0;50.625;1;33;0;33;100
cvrpsimple2i;37029;0;25.8;1;2;0;2;100
cvs08r139-94;37029;-24;0;3;14;0;14;79.31
cvs16r106-72;37029;-10;0;3;31;0;31;87.65
cvs16r128-89;37029;-11;0;3;35;0;35;88.66
cvs16r70-62;37029;-5;0;3;28;0;28;88.1
cvs16r89-60;37029;-7;0;3;29;0;29;89.23
d10200;37029;12425.583005;34.236879;1;57;0;57;100
d20200;37029;12229.625788;62.339279;1;337;0;337;100
dale-cta;37029;0;0.00473;1;269;0;269;100
dano3mip;37029;576.23162;15.294513;1;1690;0;1690;100
dano3_3;37029;576.23162;1.932181;1;1805;0;1805;100
dano3_5;37029;576.23162;2.871834;1;1684;0;1684;100
danoint;37029;62.63728;5.819184;1;17;0;17;100
dc1c;37029;1754946.863638;139.779852;1;296;0;296;100
dc1l;37029;522111667.267955;0;3;1215;11;1226;100
dcmulti;37029;184858.396836;12.823814;3;3;0;3;100
decomp1;37029;-120;98.888889;1;47;0;47;100
decomp2;37029;-160;93.138889;1;54;0;54;100
dfn-bwin-DBE;37029;797567.4;0;2;35;0;35;100
dfn-gwin-UUM;37029;27467.257235;5.653537;1;1;0;1;100
dg012142;37029;5895516.340434;39.442147;5;184;0;184;100
diameterc-mstc-v20a190d5i;37029;291;62;1;31;0;31;100
diameterc-msts-v40a100d5i;37029;324;100.621212;1;30;0;30;100
disctom;37029;-5000;51.166667;1;204;0;204;100
disktom;37029;-5000;51.166667;1;192;0;192;100
dolom1;37029;6556066.068315;110.72091;1;512;0;512;100
drayage-100-12;37029;21458.311901;43.599962;1;58;0;58;100
drayage-100-23;37029;11714.141979;43.32781;1;129;0;129;100
drayage-25-23;37029;11714.141979;42.142735;1;144;0;144;100
drayage-25-27;37029;26785.797043;43.712602;1;56;0;56;100
drayage-25-32;37029;32519.997253;43.268141;1;56;0;56;100
ds-big;37029;86.820068;30.669231;1;8161;3;8164;100
ds;37029;57.234565;33.463549;1;1049;1;1050;100
dws008-01;37029;708.876687;16.484655;2;56;0;56;100
dws008-03;37029;716.047081;7.806469;2;123;0;123;100
dws012-01;37029;3473.575073;26.230322;2;118;0;118;100
dws012-02;37029;2128.039491;19.344808;2;243;1;244;100
dws012-03;37029;2125.884828;18.678617;2;347;1;348;100
eil33-2;37029;811.278996;3.61563;1;36;0;36;100
eilA101-2;37029;803.373888;7.408683;1;884;1;885;100
eilB101;37029;1075.247691;12.807028;1;21;0;21;100
eilC76-2;37029;725.754458;7.780208;1;294;0;294;100
ej;37029;1;0.243844;1;0;0;0;100
elitserienhandball11i;37029;0;1421.352265;1;256;0;256;100
elitserienhandball13i;37029;0;1357.692232;1;267;0;267;100
elitserienhandball14i;37029;0;1543.7577;1;261;0;261;100
elitserienhandball3i;37029;0;1525.315516;1;270;0;270;100
enlight13;37029;0;0.5;1;0;0;0;100
enlight15;37029;0;0.5;1;0;0;0;100
enlight8;37029;0;0.5;1;0;0;0;100
enlight_hard;37029;0;14.5;1;0;0;0;100
eva1aprime5x5opt;37029;-497.247729;0.844656;1;386;0;386;100
eva1aprime6x6opt;37029;-495.49243;7.714269;1;1936;0;1936;100
ex10;37029;100;100;1;16839;1;16840;100
ex1010-pi;37029;304;0;3;767;4;771;29.36
ex9;37029;81;81;1;1820;1;1821;100
exp-1-500-5-5;37029;97666.305541;4.045842;2;2;0;2;100
f2000;37029;1383;1280;2;3535;0;3535;100
f2gap201600;37029;76429.862296;1.402159;1;3;0;3;100
f2gap401600;37029;82274.237434;1.19002;1;4;0;4;100
f2gap40400;37029;20650.898154;3.25358;1;1;0;1;100
f2gap801600;37029;86570.120867;5.266841;1;5;0;5;100
fast0507;37029;214;0;3;572;10;582;22.99
fastxgemm-n2r6s0t2;37029;27;9;1;33;0;33;100
fastxgemm-n2r7s4t1;37029;27;9;1;38;0;38;100
fastxgemm-n3r21s3t6;37029;84;27;1;2429;0;2429;100
fastxgemm-n3r22s4t6;37029;84;27;1;2718;0;2718;100
fastxgemm-n3r23s5t6;37029;84;27;1;2698;0;2698;100
fhnw-binpack4-48;37029;0;333.285714;2;136;0;136;100
fhnw-binpack4-58;37029;0;467.321429;2;158;1;159;100
fhnw-binpack4-77;37029;0;207.310714;2;123;0;123;100
fhnw-binschedule0;37029;12632.888779;685.581929;3;11916;15;11931;100
fhnw-binschedule2;37029;1706.886254;185.026392;3;189;1;190;100
fhnw-schedule-paira100;37029;-36.643681;5.147307;2;129;0;129;100
fhnw-schedule-paira200;37029;-73.826479;8.938667;2;265;2;267;100
fhnw-schedule-paira400;37029;-146.941079;19.26431;2;1373;12;1385;100
fhnw-schedule-pairb200;37029;-73.826479;516.184695;2;1131;3;1134;100
fhnw-schedule-pairb400;37029;-146.941079;2338.646383;2;7204;12;7216;100
fhnw-sq2;37029;0;14.298419;1;4;0;4;100
fiball;37029;137.069168;82.028566;1;116;0;116;100
fiber;37029;1023943.76;9.839127;2;3;0;3;100
fillomino7x7-0i;37029;0;0;1;29;0;29;0
fixnet6;37029;12170;0;2;1;0;1;100
fjspeasy01i;37029;216;0;1;54;0;54;0
flugpl;37029;1167185.725592;3.538918;1;0;0;0;100
g200x740;37029;45614;0;2;2;0;2;2.93
g200x740i;37029;44069;0;2;2;0;2;46.48
gasprod1-1;37029;4861.104633;51.656628;7885;902;2759;3661;100
gasprod1-2;37029;1691.141291;51.497411;6853;541;866;1407;100
gasprod1-3;37029;3682.336923;49.221179;8368;558;1080;1638;100
gasprod2-1;37029;1306101.609201;404.201103;19;1747;7;1754;100
gasprod2-2;37029;1330631.091637;502.800224;36;1778;16;1794;100
gen-ip002;37029;-511.036897;0;3;0;0;0;89.32
gen-ip016;37029;-9505.628173;1.906914;1;0;0;0;100
gen-ip021;37029;6642.05262;2.217259;4;0;0;0;100
gen-ip036;37029;-2162.833562;0;3;0;0;0;53.05
gen-ip054;37029;8365.610388;1.135203;5;0;0;0;100
gen;37029;112130.040664;7.929263;1;3;0;3;100
genus-g31-8;37029;-27;83;1;1044;0;1044;100
genus-g61-25;37029;-58;249.312678;1;696;0;696;100
genus-sym-g31-8;37029;-27;154.805251;2;3817;1;3818;100
genus-sym-g62-2;37029;-54;251.108763;2;23216;2;23218;100
genus-sym-grafo5708-48;37029;-27;115.061005;1;1423;0;1423;100
ger50-17-ptp-pop-3t;37029;3466.324873;45.213645;1;101;0;101;100
ger50-17-ptp-pop-6t;37029;6804.447088;50.477969;1;93;0;93;100
ger50-17-trans-dfn-3t;37029;3453.475245;37.741927;1;164;0;164;100
ger50-17-trans-pop-3t;37029;3456.252922;49.487013;1;174;0;174;100
ger50_17_trans;37029;6850.628623;48.22611;1;143;0;143;100
germanrr;37029;46445702.956442;53.468182;2;748;0;748;100
germany50-DBM;37029;438028;23.4;1;139;0;139;100
germany50-UUM;37029;597932.5;24.4;1;32;0;32;100
gesa2-o;37029;25748173.191117;13.380406;2;5;0;5;100
gesa2;37029;25477017.874283;13.26737;2;6;0;6;100
gfd-schedulen180f7d50m30k18-16i;37029;18;108.864749;1;5860;45;5905;100
gfd-schedulen180f7d50m30k18;37029;1;4971.136881;2;3583;15;3598;100
gfd-schedulen25f5d20m10k3i;37029;3;13.619895;1;70;0;70;100
gfd-schedulen55f2d50m30k3i;37029;3;27.695911;1;156;1;157;100
ghoulomb4-9-10i;37029;9;0;1;61;2;63;0
glass-sc;37029;29;0;3;120;1;121;26.09
glass4;37029;800002400;2.059524;1;1;0;1;100
gmu-35-40;37029;-2400283.756506;1.911023;2;9;0;9;100
gmu-35-50;37029;-2606307.146543;3.420099;2;20;0;20;100
gmut-75-50;37029;-14182312.661731;4.988967;1;585;1;586;100
gmut-76-40;37029;-14171086.316075;9.054451;1;234;0;234;100
gmut-76-50;37029;-14173884.188063;4.201959;1;465;1;466;100
gmut-77-40;37029;-14173396.636852;2.97325;1;243;0;243;100
go19;37029;95;0;3;5;0;5;13.1
gr4x6;37029;229.05;0;2;0;0;0;13.19
graph20-20-1rand;37029;-37;48.5;1;55;0;55;100
graph20-80-1rand;37029;-117;142;1;1655;1;1656;100
graph40-20-1rand;37029;-157;183.5;1;3986;2;3988;100
graph40-40-1rand;37029;-300;327;1;91793;9;91802;100
graphdraw-domain;37029;12672;18.037296;1;3;0;3;100
graphdraw-gemcutter;37029;4310;10.690226;1;1;0;1;100
graphdraw-grafo2;37029;35762;325.965485;1;758;2;760;100
graphdraw-mainerd;37029;30496;102.656285;1;83;0;83;100
graphdraw-opmanager;37029;54717;178.181738;1;435;0;435;100
gsvm2rl11;37029;35640.343493;0;3;380;0;380;96.67
gsvm2rl12;37029;50;0;3;575;0;575;100
gsvm2rl3;37029;0.6;0;3;4;0;4;78.29
gsvm2rl5;37029;10;0;3;8;0;8;84.4
gsvm2rl9;37029;16356.825869;0;3;59;0;59;100
gt2;37029;13460.233074;0.728107;1;0;0;0;100
h50x2450;37029;11147.731511;3.696751;1;26;0;26;100
h80x6320;37029;3700;0;1;23;0;23;0
h80x6320d;37029;5325.160104;2.515625;1;38;0;38;100
hanoi5;37029;1931;324;4;149;0;149;100
haprp;37029;3665963.213506;96.940858;1;5;0;5;100
harp2;37029;-74353341.5023;5.485338;1;6;0;6;100
hgms-det;37029;-53824.391476;32.676364;1;213;0;213;100
hgms30;37029;-53349.215497;60.694272;1;9341;0;9341;100
hgms62;37029;-53416.649907;61.317531;1;27431;0;27431;100
hypothyroid-k1;37029;-2902.852586;39.591978;1;8163;2;8165;100
ic97_potential;37029;4060;54.466667;2;4;0;4;100
ic97_tension;37029;3911;15.366667;2;2;0;2;100
icir97_potential;37029;6620;169.333333;2;44;0;44;100
icir97_tension;37029;6302;97.366667;2;4;0;4;100
iis-100-0-cov;37029;35;0;3;107;0;107;20.69
iis-bupa-cov;37029;46;0;3;158;1;159;27.78
iis-glass-cov;37029;26;0;3;128;1;129;23.81
iis-hc-cov;37029;22;0;3;176;3;179;29.41
iis-pima-cov;37029;39;0;3;221;1;222;18.18
irp;37029;12123.530222;6;1;70;0;70;100
istanbul-no-cutoff;37029;51.11;3.607411;1;424;0;424;100
ivu06-big;37029;135.427718;95.799872;1;55265;44;55309;100
ivu06;37029;135.901353;97.120377;1;15631;22;15653;100
ivu52;37029;480.250439;83.13028;1;7106;3;7109;100
ivu59;37029;884.456993;122.834601;1;108459;52;108511;100
janos-us-DDM;37029;1488134.75;22.375;1;5;0;5;100
k16x240;37029;11359;0;2;0;0;0;6.42
k16x240b;37029;12874;0;2;0;0;0;13
k1mushroom;37029;-4165.061224;43.877551;1;16866;7;16873;100
k1mushroomi;37029;-4208;0;1;194;7;201;0
khb05250;37029;126785464;0;2;1;0;1;18.56
l2p12;37029;2;1084.341227;1;338;0;338;100
l2p1i;37029;1;186.848182;1;799;6;805;100
l2p2i;37029;1;9.888081;1;65;0;65;100
lectsched-1-obj;37029;0;5.975758;2;228;2;230;100
lectsched-1;37029;0;3.151515;2;186;2;188;100
lectsched-2;37029;0;17.32803;5;116;2;118;100
lectsched-3;37029;0;25.257576;6;211;5;216;100
lectsched-4-obj;37029;0;12.074242;4;75;2;77;100
lectsched-5-obj;37029;0;4.117424;2;208;2;210;100
leo1;37029;1181219706.24;0;3;72;1;73;100
leo2;37029;1344214233.44;0;3;186;2;188;100
liu;37029;346;10.938399;2;5;0;5;100
loopha13;37029;6.279;1.10216;2;183;0;183;100
lotsize;37029;1335747.052789;7.405615;2;5;0;5;100
lr1dr02vc05v8a-t360;37029;120706.326475;174.298112;1;999;0;999;100
lr1dr04vc05v17a-t360;37029;247111.69248;335.090553;1;1806;1;1807;100
lr1dr12vc10v70b-t360;37029;983950.247945;1069.593454;1;43789;4;43793;100
lr2-22dr3-333vc4v17a-t60;37029;-72838.215835;239.748662;2;37378;3;37381;100
lrn;37029;42701141.648089;65.099086;2;580;0;580;100
m100n500k4r1;37029;-18;0;3;7;0;7;28
macrophage;37029;0;339;1;35;0;35;100
mad;37029;0;3.084841;1;1;0;1;100
manna81;37029;-10107;0;3;43;0;43;23.22
map06;37029;-406.181173;7.868443;1;2490;1;2491;100
map10;37029;-602.176181;11.248146;1;2513;0;2513;100
map14;37029;-778.549324;11.962355;1;2239;0;2239;100
map14860-20;37029;-998.836419;10.400693;1;2598;0;2598;100
map16715-04;37029;-296.267898;4.997036;1;2356;1;2357;100
map18;37029;-932.782685;11.173489;1;4098;0;4098;100
map20;37029;-998.836419;10.400693;1;2608;0;2608;100
mappingmesh3x3mpeg2i;37029;87.555556;87.202393;1;33;0;33;100
mario-t-hard5i;37029;-4482;10.942559;1;1354;1;1355;100
markshare1;37029;230;0;2;0;0;0;100
markshare2;37029;454;0;2;0;0;0;100
markshare_4_0;37029;226;0;2;0;0;0;100
markshare_5_0;37029;337;0;2;0;0;0;100
mas74;37029;10482.79528;3.103514;1;1;0;1;100
mas76;37029;38893.903641;2.555097;1;1;0;1;100
maxgasflow;37029;-70929535.9;647.128713;2;54;0;54;100
mc11;37029;13509;0;2;28;0;28;15.57
mc7;37029;5796;0;2;29;0;29;69.62
mc8;37029;1929;0;2;29;0;29;23.18
mcsched;37029;193774.753707;340.221655;1;125;0;125;100
methanosarcina;37029;0;313;1;100;0;100;100
mik-250-1-100-1;37029;0;0;2;2;0;2;100
mik-250-20-75-1;37029;0;0;2;3;0;3;100
mik-250-20-75-2;37029;0;0;2;3;0;3;100
mik-250-20-75-3;37029;0;0;2;3;0;3;100
mik-250-20-75-4;37029;0;0;2;3;0;3;100
mik-250-20-75-5;37029;0;0;2;3;0;3;100
milo-v12-6-r1-58-1;37029;410986.648167;146.256423;1;144;0;144;100
milo-v12-6-r1-75-1;37029;669700.757896;230.843427;1;186;0;186;100
milo-v12-6-r2-40-1;37029;205532.322265;97.799498;1;60;0;60;100
milo-v13-4-3d-3-0;37029;23359.288017;1.476277;1;13;0;13;100
milo-v13-4-3d-4-0;37029;34031.171805;2.550972;1;21;0;21;100
mine-166-5;37029;-821763677.673139;187.331384;1;193;0;193;100
mine-90-10;37029;-887165318.510226;202.375368;1;160;0;160;100
mining;37029;-880002941.351456;8441.692935;19530;106446;238309;344755;100
minutedispatchstrategy;37029;1898.391429;412.137934;2;1368;1;1369;100
misc07;37029;1415;8;1;2;0;2;100
mitre;37029;114740.518481;224.156743;1;112;0;112;100
mkc;37029;-581.85;16.208843;3;30;0;30;100
mkc1;37029;-611.85;3.942199;3;32;0;32;100
mod010;37029;6532.083333;14.166667;1;14;0;14;100
modglob;37029;20786787.016883;0;2;2;0;2;0.22
moj-mining;37029;-1520532907.35018;566.626558;2;43771;0;43771;100
momentum1;37029;134660.011921;48.045264;2;969;0;969;100
momentum2;37029;61266.821316;84.616225;3;715;0;715;100
momentum3;37029;107721.82427;144.721031;3;8303;0;8303;100
mrcpspj30-15-5i;37029;23;136.179484;1;42;0;42;100
mrcpspj30-17-10i;37029;25;28.677778;1;38;0;38;100
mrcpspj30-53-3i;37029;30;39.081217;1;39;0;39;100
msc98-ip;37029;19520966.151663;338.886443;2;4193;0;4193;100
mspp16;37029;341;1.241379;1;27676;0;27676;100
mspsphard01i;37029;16;0;1;45;0;45;0
mspsphard03i;37029;20;0;1;87;1;88;0
mtest4ma;37029;60342;0;2;2;0;2;15.71
mushroom-best;37029;1.3e-05;0.0192;1;309;0;309;100
mzzv11;37029;-22556.460829;174.328454;2;408;0;408;100
mzzv42z;37029;-18842.814586;198.473995;2;303;0;303;100
n13-3;37029;14401970;0;2;23;0;23;100
n15-3;37029;71710891;0;2;3353;0;3353;0
n2seq36f;37029;70600;0;3;33;1;34;35.25
n2seq36q;37029;103637.6;28.84;2;156;0;156;100
n3-3;37029;24003430;0;2;148;0;148;100
n3700;37029;1342560;0;2;25;0;25;9.36
n3705;37029;1342540;0;2;29;0;29;9.55
n3707;37029;1301218;0;2;32;0;32;9.65
n3709;37029;1324904;0;2;31;0;31;9.68
n370a;37029;1353042;0;2;27;0;27;0
n370b;37029;1373791;0;2;27;0;27;11.06
n3div36;37029;201600;0;3;145;4;149;54.13
n3seq24;37029;224833.068485;51.670786;3;2946;4;2950;100
n4-3;37029;13501875;0;2;52;0;52;100
n5-3;37029;12301325;0;2;17;0;17;100
n6-3;37029;16502900;0;2;59;0;59;100
n7-3;37029;14704310;0;2;44;0;44;100
n9-3;37029;21603625;0;2;144;0;144;100
nag;37029;465;14.734996;3;51;0;51;100
neos-1061020;37029;-145860.370608;501.179054;1;902;0;902;100
neos-1067731;37029;669053;81.272727;1;504;0;504;100
neos-1109824;37029;278;22;1;64;0;64;100
neos-1112782;37029;22000000110147.3;0;2;23;0;23;100
neos-1112787;37029;19500000125389.7;0;2;21;0;21;100
neos-1122047;37029;162.181757;1.265657;2;504;0;504;100
neos-1171448;37029;-309;0.936995;2;76;0;76;100
neos-1171692;37029;-273;3.730892;2;41;0;41;100
neos-1171737;37029;-195;8.004699;2;42;0;42;100
neos-1225589;37029;5e+09;0;2;1;0;1;100
neos-1311124;37029;-182;5;2;3;0;3;100
neos-1324574;37029;4.5;144;1;35;0;35;100
neos-1330346;37029;4.5;76.5;1;116;0;116;100
neos-1337307;37029;-201272;272.493985;2;52;0;52;100
neos-1354092;37029;46;238.398385;2;1065;0;1065;100
neos-1367061;37029;31320456.264497;4.625;2;2023;0;2023;100
neos-1396125;37029;3000.053717;12.531496;2;8;0;8;100
neos-1420546;37029;22124.4;103.140678;1;372;0;372;100
neos-1420790;37029;2942.750002;75.132359;1;46;0;46;100
neos-1423785;37029;-1816.666667;311.9714;1;242;0;242;100
neos-1425699;37029;3175204364.6353;5.264952;1;0;0;0;100
neos-1426635;37029;-178;6.429182;2;2;0;2;100
neos-1426662;37029;-52;10.501303;2;4;0;4;100
neos-1429212;37029;30;702.979352;1;5593;2;5595;100
neos-1430701;37029;-78;6.669599;2;2;0;2;100
neos-1436709;37029;-129;3.502607;2;3;0;3;100
neos-1440225;37029;36;32.95203;1;124;0;124;100
neos-1440460;37029;-180;4.85975;2;2;0;2;100
neos-1442119;37029;-182;2.580471;2;3;0;3;100
neos-1442657;37029;-156;4.002933;2;3;0;3;100
neos-1445532;37029;-22860;8.21746;2;92;0;92;100
neos-1445738;37029;-24232.548846;16.549339;1;145;0;145;100
neos-1445743;37029;-24579.832968;16.952539;1;144;0;144;100
neos-1445765;37029;-24699.19766;17.463301;1;162;0;162;100
neos-1456979;37029;154;8.434222;1;52;0;52;100
neos-1516309;37029;34769.833333;9.166667;2;33;0;33;100
neos-1582420;37029;88.469527;56.693409;5;85;0;85;100
neos-1593097;37029;4424;55.795872;1;115;0;115;100
neos-1599274;37029;32194.742857;6.464286;3;36;0;36;100
neos-1601936;37029;1;160.240666;1;746;0;746;100
neos-1603965;37029;619244367.662955;0.000913;1;625;0;625;100
neos-1605061;37029;6.150735;155.194245;1;2175;0;2175;100
neos-1605075;37029;3.214461;172.430143;1;2105;0;2105;100
neos-1616732;37029;173;0;3;5;0;5;8.81
neos-1620770;37029;22;35;2;42;0;42;100
neos-2294525-abba;37029;156.177251;16.374339;1;84;0;84;100
neos-2328163-agri;37029;26069;48.333333;1;60;0;60;100
neos-2624317-amur;37029;0;24.102739;1;2;0;2;100
neos-2629914-sudost;37029;39622;6.805742;1;202;0;202;100
neos-2652786-brda;37029;0;23.382167;2;2;0;2;100
neos-2657525-crna;37029;0;28.348834;2;1;0;1;100
neos-2669500-cust;37029;2221.9;230.19862;2;936;4;940;100
neos-2746589-doon;37029;1985.75;129.965898;2;336;2;338;100
neos-2974461-ibar;37029;473452396.770997;3364;2;222934;19;222953;100
neos-2978193-inde;37029;-2.418518;7.4;1;64;0;64;100
neos-2978205-isar;37029;-12.415307;28.8;1;197;0;197;100
neos-2987202-jeir;37029;-1847551552.23661;1035.632796;2;68145;1;68146;100
neos-2987310-joes;37029;-610797465.676974;19.875;2;1156;0;1156;100
neos-2991472-kalu;37029;441.200405;3.938339;5;4522;2;4524;100
neos-3004026-krka;37029;0;832;1;54;0;54;100
neos-3009394-lami;37029;0.642857;216.285714;1;4;0;4;100
neos-3024952-loue;37029;22882;103.3;1;251;0;251;100
neos-3025225-shelon;37029;0.052574;323.690533;1;100865;11;100876;100
neos-3046601-motu;37029;185;0.4492;1;1;0;1;100
neos-3046615-murg;37029;192;0.3458;1;1;0;1;100
neos-3048764-nadi;37029;-3883988306.36669;0;2;44;1;45;0
neos-3065804-namu;37029;0;0;1;207;0;207;0
neos-3068746-nene;37029;77427529.530929;55.412658;2;133;0;133;100
neos-3072252-nete;37029;10593526;1.938794;2;1;0;1;100
neos-3075395-nile;37029;54.924463;0.00048;1;152;0;152;100
neos-3083784-nive;37029;0;12;1;26;0;26;100
neos-3083819-nubu;37029;6290575.552807;13.541087;1;45;0;45;100
neos-3116779-oban;37029;0;0;1;22;0;22;0
neos-3118745-obra;37029;357;0;2;3;0;3;40
neos-3148108-pahi;37029;0;0;1;279;1;280;0
neos-3209462-rhin;37029;0;49.45122;2;4358;1;4359;100
neos-3209519-ruhr;37029;332.85;25.900482;1;57;0;57;100
neos-3214367-sovi;37029;87802.732596;100.08443;1;2091;0;2091;100
neos-3216931-puriri;37029;58817.353066;51.40019;1;1229;0;1229;100
neos-3226448-wkra;37029;0;512.043709;1;799;0;799;100
neos-3237086-abava;37029;0;96;1;268;0;268;100
neos-3322547-alsek;37029;616;115.178534;2;10721;28;10749;100
neos-3352863-ancoa;37029;495300;0;2;820;6;826;100
neos-3354841-apure;37029;48447.926267;4.407066;1;2646;3;2649;100
neos-3355120-tarago;37029;-20453473.616781;80.899969;1;643;0;643;100
neos-3355323-arnon;37029;0;33.818182;4;84;2;86;100
neos-3372571-onahau;37029;0.57699;8.695953;2;1519;0;1519;100
neos-3373491-avoca;37029;21687686014.0154;26.555947;1;7;0;7;100
neos-3381206-awhea;37029;432;61.334767;2;5;0;5;100
neos-3402294-bobin;37029;0;39.298587;1;1040;2;1042;100
neos-3426085-ticino;37029;235;41.78747;3;29;0;29;100
neos-3426132-dieze;37029;427;103.670666;2;56;0;56;100
neos-3437289-erdre;37029;0;0;1;80;1;81;0
neos-3530903-gauja;37029;170;33.253136;3;5;0;5;100
neos-3530905-gaula;37029;153;29.042208;2;4;0;4;100
neos-3555904-turama;37029;-41.45;29;1;893;0;893;100
neos-3572885-glina;37029;0;0;1;394;2;396;0
neos-3581454-haast;37029;1640;52;1;104;0;104;100
neos-3592146-hawea;37029;7237144.855333;13.694653;1;44;0;44;100
neos-3594536-henty;37029;383205;2498;1;141;1;142;100
neos-3603137-hoteo;37029;0;38.166667;3;45;0;45;100
neos-3610040-iskar;37029;46;0;2;3;0;3;24.32
neos-3610051-istra;37029;64;0;2;10;0;10;30.61
neos-3610173-itata;37029;180;0;2;7;0;7;21.62
neos-3611447-jijia;37029;129;0;2;3;0;3;20.56
neos-3611689-kaihu;37029;151;0;2;3;0;3;26.89
neos-3615091-sutlej;37029;-1506391.117177;170;1;1880;4;1884;100
neos-3627168-kasai;37029;1020229.4;0;2;4;0;4;3.2
neos-3634244-kauru;37029;0;152.72;1;4691;8;4699;100
neos-3636886-kereu;37029;4092.95754;2e-05;2;54;0;54;100
neos-3656078-kumeu;37029;-18774.7;92.164195;2;188;0;188;100
neos-3660371-kurow;37029;286.534383;17.739294;1;46;0;46;100
neos-3661949-lesse;37029;688975700;0.00026;2;64;0;64;100
neos-3665875-lesum;37029;248.325;41.380444;2;74;0;74;100
neos-3682128-sandon;37029;79915933.274829;141.641588;2;341;0;341;100
neos-3691541-lonja;37029;-0.079271;1.110009;2;46;0;46;100
neos-3695882-vesdre;37029;-145935.214286;38.466278;1;542;0;542;100
neos-3696678-lyvia;37029;5.599133;305.182559;2;53;0;53;100
neos-3699377-maori;37029;135877.224265;86.475608;2;110;0;110;100
neos-3703351-marne;37029;317056.210386;71.850613;2;58;0;58;100
neos-3740487-motru;37029;152.145486;225.379322;2;41014;20;41034;100
neos-3754480-nidda;37029;-1216923.270104;12.186832;1;3;0;3;100
neos-3755335-nizao;37029;50.030157;76.942384;2;534;0;534;100
neos-3759587-noosa;37029;48.334468;2.274444;2;363;0;363;100
neos-3761878-oglio;37029;422769.022545;74.732087;2;52;0;52;100
neos-3762025-ognon;37029;603955.746492;53.791954;2;40;0;40;100
neos-4165869-wannon;37029;282.410166;126.294292;3;439;1;440;100
neos-4260495-otere;37029;3336.109119;244.496957;2;871;5;876;100
neos-4264598-oueme;37029;4322420655.77198;2999.342361;241;3939;132;4071;100
neos-4285819-pedja;37029;9.198008;18.083988;2;130539;54;130593;100
neos-4290317-perth;37029;6352398.05574;0;2;624;1;625;100
neos-4292145-piako;37029;203285265.067233;3216.29981;241;3936;126;4062;100
neos-4295773-pissa;37029;0;3220.505376;1;5936;3;5939;100
neos-4300652-rahue;37029;0;52.333333;2;753;1;754;100
neos-4306827-ravan;37029;-35696.901913;771.837676;2;1120;6;1126;100
neos-4321076-ruwer;37029;1880.558333;39.333333;1;15714;1;15715;100
neos-4322846-ryton;37029;0.419848;25.388427;1;544;2;546;100
neos-4332801-seret;37029;222328.384492;5750.571985;4;135392;1344;136736;100
neos-4332810-sesia;37029;-33455.127882;4060.356957;11;125371;2928;128299;100
neos-4333464-siret;37029;24.731464;0.125;2;79;0;79;100
neos-4333596-skien;37029;-14653956.91493;0.180763;1;23;0;23;100
neos-4335793-snake;37029;0;300.868689;2;1097;1;1098;100
neos-4338804-snowy;37029;1447;0.3136;3;6;0;6;100
neos-4343293-stony;37029;51.62736;0.5;2;74;0;74;100
neos-4355351-swalm;37029;33.822611;0.094819;2;191;0;191;100
neos-4358725-tagus;37029;6199.400001;197.672071;73;683;16;699;100
neos-4359986-taipa;37029;0.296593;39.671142;1;1607;2;1609;100
neos-4360552-sangro;37029;-29.5;572.086779;1;11056;0;11056;100
neos-4387871-tavua;37029;36.445048;0.2;2;48;0;48;100
neos-4391920-timok;37029;9e-06;37.747142;1;7594;2;7596;100
neos-4393408-tinui;37029;340.267489;0.2;2;42;0;42;100
neos-4408804-prosna;37029;914.483516;66.321429;1;3225;1;3226;100
neos-4409277-trave;37029;0;347.723278;1;2210;1;2211;100
neos-4413714-turia;37029;43.474651;370.587709;1;2198;6;2204;100
neos-4532248-waihi;37029;0;26.808725;1;771;2;773;100
neos-4533806-waima;37029;3063.318841;99;1;1156;2;1158;100
neos-4545615-waita;37029;3606.59419;108.263827;1;14579;21;14600;100
neos-4555749-wards;37029;3026.812121;70;1;849;2;851;100
neos-4562542-watut;37029;3743.304348;85.428571;1;3020;3;3023;100
neos-4647027-thurso;37029;26911.641616;127.083433;1;2575;0;2575;100
neos-4647030-tutaki;37029;26911.641616;130.175014;1;2783;0;2783;100
neos-4647032-veleka;37029;26587.908699;174.815461;1;3884;0;3884;100
neos-4650160-yukon;37029;-22688.54768;228.864;1;5;0;5;100
neos-4722843-widden;37029;1841.255082;1452.768981;2;438;5;443;100
neos-4724674-aorere;37029;3758.753179;59.078997;3;537;6;543;100
neos-4736745-arroux;37029;653873224.676537;1.560199;2;42;0;42;100
neos-4738912-atrato;37029;617323325.173629;52.400465;2;47;0;47;100
neos-4754521-awarau;37029;0;0;1;1133;7;1140;0
neos-4760493-puerua;37029;1908.243695;237.071976;1;33764;1;33765;100
neos-476283;37029;406.244708;4.622056;2;4327;0;4327;100
neos-4763324-toguru;37029;1120.986062;232.945926;1;31334;1;31335;100
neos-4797081-pakoka;37029;0;821.218711;1;4994;0;4994;100
neos-4805882-barwon;37029;1603.90283;209.539059;1;219;0;219;100
neos-480878;37029;515.138796;1.008444;2;17;0;17;100
neos-4954274-beardy;37029;18659.208282;301.285291;2;972;0;972;100
neos-4954672-berkel;37029;3733961;4.007059;2;3;0;3;100
neos-4966258-blicks;37029;354.545455;449.137117;3;1439;2;1441;100
neos-4971100-bodrog;37029;0;0;2;75;0;75;100
neos-4972437-bojana;37029;355.557128;29.484099;2;9112;1;9113;100
neos-4972461-bolong;37029;465.045599;63.71069;2;5551;1;5552;100
neos-4976951-bunnoo;37029;375.694372;27.122883;2;5613;1;5614;100
neos-4984115-canche;37029;-10414620.716097;6.967648;1;18340;0;18340;100
neos-498623;37029;16;43.578586;1;145;0;145;100
neos-5013590-toitoi;37029;1064.447092;169;1;12578;1;12579;100
neos-5018451-chiese;37029;-149772385.216405;18.530618;1;64414;0;64414;100
neos-503737;37029;50;47.555718;1;36;0;36;100
neos-5041822-cockle;37029;5696053.417116;2.418448;3;2754;10;2764;100
neos-5044663-wairoa;37029;4653100;578.73613;1;23731;1;23732;100
neos-5045105-creuse;37029;19.06667;19.669391;1;82;0;82;100
neos-5049753-cuanza;37029;464;69.6;3;2772;1;2773;100
neos-5051588-culgoa;37029;128.75;32.57449;1;138;0;138;100
neos-5052403-cygnet;37029;228.7871;83.839163;9;37202;10;37212;100
neos-506422;37029;0;6.6;1;43;0;43;100
neos-506428;37029;145945;95.648936;1;549;0;549;100
neos-5075914-elvire;37029;277.341888;1.484053;2;50;0;50;100
neos-5076235-embley;37029;1930;0.115385;2;825;0;825;100
neos-5078479-escaut;37029;7280.474567;0.468278;2;42;0;42;100
neos-5079731-flyers;37029;2004;1.087912;2;791;0;791;100
neos-5083528-gimone;37029;0;20.875;1;258;1;259;100
neos-5093327-huahum;37029;3934;1.841667;2;760;0;760;100
neos-5100895-inster;37029;2084;3.582418;2;606;0;606;100
neos-5102383-irwell;37029;1740;2.483516;2;925;0;925;100
neos-5104907-jarama;37029;639.917149;47.86104;2;9338;1;9339;100
neos-5106984-jizera;37029;721;3.5;2;3847;1;3848;100
neos-5107597-kakapo;37029;0;0.59125;2;42;0;42;100
neos-5108386-kalang;37029;620.501637;53.159082;2;14665;2;14667;100
neos-5114902-kasavu;37029;518;141.333333;3;13076;3;13079;100
neos-5115478-kaveri;37029;0;0.529375;2;44;0;44;100
neos-5116085-kenana;37029;452;142;3;5592;2;5594;100
neos-5118834-korana;37029;569.216333;121.434394;2;9782;2;9784;100
neos-5118851-kowhai;37029;1134;5.86;2;5669;2;5671;100
neos-5123665-limmat;37029;652.42743;72.359737;2;18180;2;18182;100
neos-5125849-lopori;37029;0;51.956886;1;41;0;41;100
neos-5129192-manaia;37029;0;10;1;3870;4;3874;100
neos-5138690-middle;37029;605.364996;107.846299;2;16196;2;16198;100
neos-5140963-mincio;37029;8877;2.142857;1;1;0;1;100
neos-5149806-wieprz;37029;0.027694;5.467604;3;477;5;482;100
neos-5151569-mologa;37029;686023627.750363;27.702234;2;2076;1;2077;100
neos-5178119-nalagi;37029;8.569859;18.674756;2;75;0;75;100
neos-5182409-nasivi;37029;0;18.341185;1;8;0;8;100
neos-5188808-nattai;37029;0;10.715654;1;594;0;594;100
neos-5189128-totara;37029;330131.390743;21.863581;1;963;0;963;100
neos-5192052-neckar;37029;-11980000;0.333333;3;0;0;0;100
neos-5193246-nerang;37029;0;707.729862;1;946;0;946;100
neos-5195221-niemur;37029;0;722.524895;1;895;0;895;100
neos-5196530-nuhaka;37029;0;698.361784;1;617;0;617;100
neos-520729;37029;-1391291.666667;7.783333;1;499;0;499;100
neos-5221106-oparau;37029;0;51.816243;1;256;0;256;100
neos-5223573-tarwin;37029;0.1058;0.258185;1;15468;1;15469;100
neos-5251015-ogosta;37029;0.1058;0.226665;1;12399;0;12399;100
neos-525149;37029;60;12.153846;1;271;0;271;100
neos-5260764-orauea;37029;58748.022532;10.633838;1;63;0;63;100
neos-5261882-treska;37029;22721.328;7.770659;1;14;0;14;100
neos-5266653-tugela;37029;20969.906674;15.508215;1;139;0;139;100
neos-5273874-yomtsa;37029;0;0.2152;1;15152;0;15152;100
neos-555001;37029;910619.201473;185.329242;1;37;0;37;100
neos-555343;37029;1241512.54944;273.503416;1;40;0;40;100
neos-555424;37029;1196312.54944;237.883186;1;40;0;40;100
neos-555884;37029;1026121.836055;271.3209;1;43;0;43;100
neos-565672;37029;43884.639336;66.477422;3;16967;8;16975;100
neos-574665;37029;4948073.456141;10.746401;1;30;0;30;100
neos-578379;37029;0;134.076115;1;1166;0;1166;100
neos-585192;37029;-1999690.155301;98.986682;2;216;0;216;100
neos-585467;37029;-1999711.795869;82.239088;2;22;0;22;100
neos-595904;37029;61134.474995;16.114622;2;65;0;65;100
neos-619167;37029;1.481241;35.984608;1;134;0;134;100
neos-631517;37029;6494999.999936;64.357845;1;8;0;8;100
neos-631710;37029;515;243.082736;2;5766;7;5773;100
neos-633273;37029;4678552871.15256;377.739286;1;210;0;210;100
neos-662469;37029;184340.629649;94.654114;1;422;0;422;100
neos-686190;37029;5134.81383;17.515957;1;107;0;107;100
neos-691058;37029;234;83.756531;1;186;0;186;100
neos-693347;37029;234;78.950927;1;657;0;657;100
neos-738098;37029;-1099;222.818437;1;127;0;127;100
neos-777800;37029;-80;67.656924;1;45;0;45;100
neos-780889;37029;3421500;0;1;648;9;657;0
neos-787933;37029;300;0;2;238;13;251;100
neos-799711;37029;-11228065.153797;0.946665;1;1252;0;1252;100
neos-799716;37029;4932670.661692;0.575059;1;131;0;131;100
neos-807639;37029;492.688889;1.37037;2;9;0;9;100
neos-820879;37029;24874.267857;62.867619;1;99;0;99;100
neos-824661;37029;65;60.642857;2;282;0;282;100
neos-824695;37029;63;33.8;2;101;0;101;100
neos-826224;37029;153;70;2;204;0;204;100
neos-826650;37029;32;109.347222;2;43;0;43;100
neos-826694;37029;84;92.333333;2;89;0;89;100
neos-826812;37029;86.011;151.137255;2;111;0;111;100
neos-826841;37029;32.0082;110.679849;2;42;0;42;100
neos-827015;37029;2.098071;332.649497;1;1607;1;1608;100
neos-827175;37029;121.00152;83.555556;2;169;0;169;100
neos-829552;37029;2.098071;250.649497;1;1496;0;1496;100
neos-831188;37029;1.76772;215.733333;1;75;0;75;100
neos-847302;37029;0;51.325978;1;51;0;51;100
neos-848198;37029;168781;0;2;140;0;140;100
neos-848589;37029;0;0.075873;1;1523;1;1524;100
neos-849702;37029;0;88.550656;1;24;0;24;100
neos-850681;37029;2087;55.075614;1;156;0;156;100
neos-860300;37029;1666.068586;9;1;52;0;52;100
neos-872648;37029;52.674788;0;2;1197;6;1203;8.37
neos-873061;37029;152.429202;0;2;1225;5;1230;34.11
neos-876808;37029;10030.533833;259.649605;2;6472;3;6475;100
neos-885086;37029;-243;13.945733;2;193;0;193;100
neos-885524;37029;11771.55529;9.581376;2;179;3;182;100
neos-911880;37029;23.26;17.220292;1;2;0;2;100
neos-911970;37029;23.26;20.048919;1;3;0;3;100
neos-913984;37029;1000;37.312893;1;185;2;187;100
neos-914441;37029;5660364.28377;78.177859;1;1794;0;1794;100
neos-916792;37029;26.203596;16.256328;2;91;0;91;100
neos-932721;37029;513000;0;4;108;3;111;100
neos-932816;37029;513000;0;3;233;8;241;100
neos-933562;37029;0;237.810567;1;65;0;65;100
neos-933638;37029;318942.311605;0;3;251;5;256;100
neos-933966;37029;348444.51844;0;3;190;5;195;100
neos-934278;37029;340538.344697;0;3;315;3;318;100
neos-935234;37029;370343.764662;0;3;361;1;362;100
neos-935627;37029;19302.297957;0;3;417;1;418;100
neos-935769;37029;20652.761822;0;3;375;1;376;100
neos-937511;37029;46757.302874;0;3;446;1;447;100
neos-937815;37029;45496.73248;0;3;553;1;554;100
neos-941262;37029;47366.622978;0;3;387;1;388;100
neos-941313;37029;9431.37037;215.962963;2;606;5;611;100
neos-942830;37029;12;68.088474;1;33;0;33;100
neos-948126;37029;46137.445498;0;3;383;1;384;100
neos-948346;37029;-1.6;2.766667;4;523;3;526;100
neos-950242;37029;2;94;2;139;0;139;100
neos-953928;37029;-98.806667;0;4;253;4;257;1.1
neos-954925;37029;-227.766667;0;5;1059;20;1079;4.21
neos-956971;37029;-2.74;0.942917;3;747;3;750;100
neos-957143;37029;-169.042606;46.981481;4;627;3;630;100
neos-957323;37029;-173.845679;22.730769;3;365;2;367;100
neos-957389;37029;1.5;37.849369;1;119;0;119;100
neos-960392;37029;-238;290.178312;1;263;1;264;100
neos-983171;37029;48618.004774;0;3;437;1;438;100
neos-984165;37029;44499.5052;0;3;482;1;483;100
neos13;37029;-126.178378;42.587671;3;235;0;235;100
neos15;37029;144796.909577;0;2;1;0;1;79.65
neos16;37029;429;14.5;2;3;0;3;100
neos17;37029;0.222688;0;2;6;0;6;48.46
neos18;37029;11;56.166667;3;75;0;75;100
neos2;37029;-4717.666848;6.724359;1;8;0;8;100
neos22;37029;413700;227;1;31;0;31;100
neos5;37029;17.25;0;3;1;0;1;15
neos6;37029;110.98976;27.902196;4;101;1;102;100
neos8;37029;-2885.143864;22.041691;3;838;1;839;100
neos808444;37029;0;213.399502;1;252;0;252;100
neos9;37029;780;44.25;1;295;0;295;100
net12;37029;47.514236;175.350347;3;836;0;836;100
netdiversion;37029;455.8;769.6;2;7784;4;7788;100
newdano;37029;11.724138;8.447296;1;2;0;2;100
nexp-150-20-1-5;37029;84;0;2;36;0;36;27.27
nexp-150-20-8-5;37029;600;0;2;79;0;79;100
nexp-50-20-1-1;37029;34;0;2;0;0;0;17.24
nexp-50-20-4-2;37029;120;0;2;2;0;2;69.01
nh97_potential;37029;1462;73.2;2;5;0;5;100
nh97_tension;37029;1438;81.583333;2;2;0;2;100
nj1;37029;0;607;1;547;1;548;100
nj2;37029;0;607;1;647;1;648;100
nj3;37029;0;607;1;69729;1;69730;100
nobel-eu-DBE;37029;7426411.5;1.365;2;89;0;89;100
noswot;37029;-9;0;2;1;0;1;78.05
ns1111636;37029;96.25;19.25;1;629;1;630;100
ns1116954;37029;0;155.073174;1;878;0;878;100
ns1208400;37029;0;93.553865;1;62;0;62;100
ns1430538;37029;73.621609;9.970024;1;650;0;650;100
ns1456591;37029;361.939022;19;1;132;0;132;100
ns1606230;37029;13.225;179.971152;1;2005;0;2005;100
ns1631475;37029;817.193748;716.662243;1;1538;1;1539;100
ns1663818;37029;1;9.141146;1;6016;3;6019;100
ns1679495;37029;3337055.001914;100.246101;2;50245;1;50246;100
ns1685374;37029;-51.800913;96.218654;1;53893;1;53894;100
ns1688347;37029;2;7.363183;1;54;0;54;100
ns1690781;37029;-1022.785697;17.664172;2;195;0;195;100
ns1696083;37029;2;12.504268;1;169;0;169;100
ns1758913;37029;-1501.183256;121.987025;1;10128;0;10128;100
ns1760995;37029;-1379.173237;142;1;21217;1;21218;100
ns1778858;37029;-22635740;227.465047;2;368;0;368;100
ns1828997;37029;0;75;2;1136;2;1138;100
ns1830653;37029;6153;56.373873;1;144;0;144;100
ns1849932;37029;546;5.42577;1;1135;4;1139;100
ns1853823;37029;1172000;1386;2;55092;10;55102;100
ns1854840;37029;1.432e+11;1139.47326;2;6751;6;6757;100
ns1856153;37029;0;248.911984;1;152;0;152;100
ns1904248;37029;0;854.146124;14;2564;18;2582;100
ns1905797;37029;11.75098;19.65;1;199;0;199;100
ns1905800;37029;6.4366;16.364665;1;44;0;44;100
ns1952667;37029;0;10.112982;1;214;0;214;100
ns2017839;37029;77026281754033.4;1.017799;2;7829;0;7829;100
ns2034125;37029;0;796.623735;2;1977;0;1977;100
ns2071214;37029;0;2.208125;1;89;0;89;100
ns2081729;37029;4.6;1.04;2;4;0;4;100
ns2122698;37029;62785.622771;194.641858;1;595;1;596;100
ns2124243;37029;53998.333333;195.416667;1;485;0;485;100
ns2137859;37029;24629;42.075016;1;876;4;880;100
ns4-pr3;37029;36073;12;1;101;0;101;100
ns4-pr6;37029;29145.75;8.875;1;41;0;41;100
ns4-pr9;37029;35175;9;1;80;0;80;100
ns894236;37029;18;199.499882;2;386;0;386;100
ns894244;37029;16;342.075798;2;1390;1;1391;100
ns894786;37029;14;210.864769;2;1502;1;1503;100
ns894788;37029;7;91.946694;2;154;0;154;100
ns903616;37029;22;385.201946;2;1172;1;1173;100
nsa;37029;91.44794;7.482504;1;8;0;8;100
nsr8k;37029;17500809.511815;639.929911;1;8178;1;8179;100
nsrand-ipx;37029;646400;0;2;63;1;64;100
nu120-pr12;37029;38070;13.695833;1;42;0;42;100
nu120-pr3;37029;21306.442308;42.751022;1;105;0;105;100
nu120-pr9;37029;19062.5;28.652083;1;74;0;74;100
nu25-pr12;37029;52757.5;11.9;1;44;0;44;100
nu4-pr9;37029;35175;21.713333;1;78;0;78;100
nu60-pr9;37029;22850;28.383333;1;75;0;75;100
nucorsav;37029;29.0461;81.214406;2;62483;7;62490;100
nursesched-medium-hint03;37029;33.468485;460.316255;1;1198;0;1198;100
nursesched-medium04;37029;398;286.520833;2;719;0;719;100
nursesched-sprint-hidden09;37029;580.911765;177.875;2;327;0;327;100
nursesched-sprint-late03;37029;34.254806;178.177416;1;363;0;363;100
nursesched-sprint02;37029;170.416667;127.291667;2;201;0;201;100
nw04;37029;16310.666667;2;1;237;2;239;100
ofi;37029;6131846109.62063;1781.999298;135;9661;101;9762;100
ofi2;37029;6124829152.73116;3158.688481;133;7017;128;7145;100
oocsp-racks030e6cci;37029;0;0;1;228;2;230;0
opm2-z10-s2;37029;-20977;0;6;23689;12;23701;37.99
opm2-z10-s4;37029;-19346;0;6;25769;11;25780;41.85
opm2-z11-s8;37029;-23747;0;5;52344;14;52358;45.39
opm2-z12-s14;37029;-34474;0;6;114706;28;114734;46.38
opm2-z12-s7;37029;-35909;0;6;106505;24;106529;45.19
opm2-z12-s8;37029;-33082;0;6;113691;25;113716;43.49
opm2-z6-s1;37029;-3261;0;4;331;1;332;47.42
opm2-z7-s2;37029;-6782;0;5;870;2;872;34.03
opm2-z7-s8;37029;-6367;0;4;890;2;892;43.36
opm2-z8-s0;37029;-7499;0;5;4121;5;4126;52.46
opt1217;37029;-20.02139;8.22549;1;2;0;2;100
osorio-cta;37029;0;3.5e-05;1;63;0;63;100
p0201;37029;6875;20;1;1;0;1;100
p100x588b;37029;58977;0;2;1;0;1;23.18
p200x1188c;37029;15747;0;2;2;0;2;4.44
p2756;37029;2763;2.212891;2;6;0;6;100
p500x2988;37029;72594;0;2;32;0;32;1.06
p500x2988c;37029;17212;0;2;30;0;30;13.13
p500x2988d;37029;6;0;2;30;0;30;0
p6b;37029;-52;0;3;37;0;37;17.46
p80x400b;37029;45896;0;2;1;0;1;15.7
pb-fit2d;37029;-22372.476239;842.898884;1;7764;4;7768;100
pb-gfrd-pnc;37029;8316.011268;30.700616;1;129;0;129;100
pb-grow22;37029;-449681.200587;122.632175;1;511;0;511;100
pb-market-split8-70-4;37029;0;2.197219;1;0;0;0;100
pb-simp-nonunif;37029;6;513.5;2;3885;23;3908;100
peg-solitaire-a3;37029;1;289.311002;1;407;0;407;100
pg;37029;-11098.657382;17.215049;2;5;0;5;100
pg5_34;37029;-16012.248077;18.476238;2;8;0;8;100
physiciansched3-3;37029;2432694.766159;1308.126367;17;55539;26;55565;100
physiciansched3-4;37029;1124678.224456;1173.049171;9;36538;14;36552;100
physiciansched5-3;37029;5180;1133.735241;4;1317;1;1318;100
physiciansched6-1;37029;7500;799.143056;2;672;5;677;100
physiciansched6-2;37029;43012.5;744.696528;2;605;4;609;100
pigeon-08;37029;-8000;8.25974;1;2;0;2;100
pigeon-10;37029;-10000;13.559596;1;3;0;3;100
pigeon-11;37029;-11000;16.690909;1;3;0;3;100
pigeon-12;37029;-12000;21.818182;1;4;0;4;100
pigeon-13;37029;-13000;24;1;4;0;4;100
pigeon-16;37029;-16000;74.018182;1;7;0;7;100
pigeon-19;37029;-19000;59.036364;1;29;0;29;100
pigeon-20;37029;-20000;62.509091;1;33;0;33;100
piperout-03;37029;68814.99759;424.596014;17;353;3;356;100
piperout-08;37029;99128.924471;558.127794;17;310;4;314;100
piperout-27;37029;6970;1154.464464;12;526;6;532;100
piperout-d20;37029;25533.842105;676.796097;2;1057;1;1058;100
piperout-d27;37029;7083.116279;1022.542306;2;1509;1;1510;100
pk1;37029;0;2.791536;1;0;0;0;100
polygonpack3-15;37029;-96519350.40932;31.158333;3;1427;1;1428;100
polygonpack4-10;37029;-93676953.4701;20.073813;3;443;0;443;100
polygonpack4-15;37029;-114052801.79086;42.642788;3;1387;1;1388;100
polygonpack4-7;37029;-75324958.8742;9.351219;3;232;0;232;100
polygonpack5-15;37029;-42382234.50354;24.00431;3;1704;1;1705;100
pp08a;37029;15000;0;2;0;0;0;100
pp08aCUTS;37029;16630.402442;0;2;2;0;2;100
probportfolio;37029;5;15.184084;2;2;0;2;100
prod1;37029;-100;6.72495;2;1;0;1;100
prod2;37029;-100;4.433874;2;1;0;1;100
proteindesign121hz512p19;37029;3197.772133;67.38213;1;16993;58;17051;100
proteindesign121hz512p9;37029;1423.904449;61.920249;1;724;3;727;100
proteindesign121pgb11p9;37029;1173.710433;49.777201;1;645;2;647;100
proteindesign122trx11p8;37029;1720.461105;46.268597;1;525;5;530;100
protfold;37029;0;35;2;15;0;15;100
pw-myciel4;37029;0;51.865481;6;60;0;60;100
pythago7824;37029;0;580.777778;6;808;2;810;100
pythago7825;37029;0;586.777778;8;753;3;756;100
qap10;37029;332.566228;55;1;395;0;395;100
qiu;37029;1805.177143;0;2;5;0;5;100
qnet1;37029;98035.87;7.221868;2;18;0;18;100
qnet1_o;37029;96705.12;0;2;7;0;7;100
queens-30;37029;-29;0;3;189;1;190;27.5
r4l4-02-tree-bounds-50;37029;510876207;651.016667;2;50;0;50;100
r50x360;37029;2016;0;2;1;0;1;21.96
r80x800;37029;5520;0;2;1;0;1;3.53
radiationm18-12-05;37029;17554.5;196.264403;1;194;0;194;100
radiationm40-10-02;37029;155306.7;933.01825;1;1105;4;1109;100
rail01;37029;-92.0873;2555.841711;1;10814;3;10817;100
rail02;37029;-206.6102;3014.501667;1;135534;7;135541;100
rail03;37029;-920.273763;12441.976674;1;168089;27;168116;100
rail507;37029;217;0;3;671;9;680;24.71
railway_8_1_0;37029;397;59.076317;3;9;0;9;100
ramos3;37029;377;0;3;1417;1;1418;96.35
ran12x21;37029;4080;0;2;0;0;0;11.35
ran13x13;37029;3521;0;2;0;0;0;8.27
ran14x18-disj-8;37029;12451.012696;0;2;19;0;19;100
ran14x18;37029;4265;0;2;0;0;0;14.9
ran16x16;37029;4333;0;2;0;0;0;13.34
rd-rplusc-21;37029;100;4.122871;1;525;0;525;100
reblock115;37029;-39365983.337347;271.565472;1;198;0;198;100
reblock166;37029;-886882876.965829;382.279623;1;471;0;471;100
reblock354;37029;-39640995.765204;569.832903;3;807;0;807;100
reblock420;37029;-886535897.522137;986.979676;1;2314;1;2315;100
reblock67;37029;-39339910.923037;159.950504;1;53;0;53;100
rfds-4-days;37029;-1158940.978167;68.027009;1;73704;8;73712;100
rlp1;37029;13.244444;9.961905;1;1;0;1;100
rmatr100-p10;37029;360.593308;9.692735;1;212;0;212;100
rmatr100-p5;37029;762.040054;5;1;417;0;417;100
rmatr200-p10;37029;1550.620783;10;1;10538;0;10538;100
rmatr200-p20;37029;688.357943;19.982266;1;3482;0;3482;100
rmatr200-p5;37029;3283.653831;5;1;11049;0;11049;100
rmine10;37029;-1926.821009;886.351115;2;4242;1;4243;100
rmine11;37029;-2502.695945;1244.857117;14277;11951;9188;21139;100
rmine13;37029;-3504.619914;1108.274293;2;43187;2;43189;100
rmine14;37029;-4308.088129;2210.0707;8123;93777;11327;105104;100
rmine15;37029;-5040.470724;4256.942532;4;175192;10;175202;100
rmine6;37029;-435.955252;50.204598;8322;161;325;486;100
rocI-3-11;37029;-111086.671772;567.73396;1;49;0;49;100
rocI-4-11;37029;-11111086.671772;800.875467;1;60;0;60;100
rocII-10-11;37029;-11.974865;290.286693;1;528;0;528;100
rocII-4-11;37029;-11.937162;82.5;1;136;0;136;100
rocII-5-11;37029;-11.94973;122.235744;1;169;0;169;100
rocII-7-11;37029;-11.964093;212.677972;1;317;0;317;100
rocII-8-11;37029;-11.968581;244.764303;1;393;0;393;100
rocII-9-11;37029;-11.972072;279.075237;1;467;0;467;100
rococoB10-011000;37029;8350.199468;49.840978;1;115;0;115;100
rococoC10-001000;37029;7515.271029;14.894221;1;56;0;56;100
rococoC11-010100;37029;8773.206543;49.89581;1;142;0;142;100
rococoC11-011100;37029;9024.205406;56.60339;1;131;0;131;100
rococoC12-010001;37029;26787.292147;50.829414;1;202;0;202;100
rococoC12-111000;37029;27337.357381;53.501346;1;238;0;238;100
roi2alpha3n4;37029;-80.526722;7.807845;2;684;0;684;100
roi5alpha10n8;37029;-87.787142;16;2;2120;3;2123;100
roll3000;37029;11097.127677;46.77651;3;38;0;38;100
rout;37029;981.864286;9.898077;1;2;0;2;100
rpp22falsei;37029;0;0;1;40;0;40;0
rvb-sub;37029;11.206514;4.571429;1;684;0;684;100
s100;37029;-0.171097;39.317795;1;26015;8;26023;100
s1234;37029;0.361925;1.578587;3;713;1;714;100
s250r10;37029;-0.165732;55.381636;2;9664;7;9671;100
s55;37029;-22.151773;0;1;1712;3;1715;0
s82;37029;-33.833613;482.284414;2;206543;55;206598;100
satellites1-25;37029;-20;68.01912;1;135;0;135;100
satellites2-25;37029;-30;356.7768;1;27150;0;27150;100
satellites2-40;37029;-30;133.152561;1;4762;1;4763;100
satellites2-60-fs;37029;-30;507.455315;1;2955;1;2956;100
satellites2-60;37029;-30;133.152561;1;4974;0;4974;100
satellites3-25;37029;-39;966.359942;1;234508;2;234510;100
satellites3-40-fs;37029;-39;942.263869;1;23158;2;23160;100
satellites3-40;37029;-39;963.231625;1;233541;2;233543;100
savsched1;37029;31271.151902;0;2;121796;25;121821;100
scpj4scip;37029;213;0;3;1227;21;1248;65.12
scpk4;37029;599;0;3;2640;26;2666;86.6
scpl4;37029;437;0;3;4919;43;4962;66.16
scpm1;37029;905;0;3;46316;127;46443;61.32
scpn2;37029;764;0;3;72683;261;72944;43.07
sct1;37029;-218.139003;91.32546;1;1378;0;1378;100
sct2;37029;-231.116964;14.501214;1;62;0;62;100
sct31;37029;-31.962662;30.054226;1;162;0;162;100
sct32;37029;-62.990833;53.144038;1;677;0;677;100
sct5;37029;-228.176552;35.395811;2;260;0;260;100
seqsolve1;37029;4379.032014;371.073706;19;4059;37;4096;100
seqsolve2short4288;37029;0;419.969766;4;3155;10;3165;100
seqsolve3short4288excess384;37029;-46401.234768;425.509375;7;12862;16;12878;100
set1ch;37029;110241.5;0;2;1;0;1;100
set3-09;37029;1263.077974;49.748593;3;39;0;39;100
set3-10;37029;788.890655;50.61299;3;39;0;39;100
set3-15;37029;8364.040745;53.876403;3;42;0;42;100
set3-16;37029;9916.808562;58.149187;3;41;0;41;100
set3-20;37029;10347.381087;53.849605;3;39;0;39;100
seymour-disj-10;37029;666.999999;2e-06;2;1824;0;1824;100
seymour;37029;460;0;3;249;1;250;8.75
seymour1;37029;426.819841;0;3;249;0;249;3.91
shiftreg1-4;37029;131.656032;300.178571;1;58;0;58;100
shiftreg2-7;37029;206.733052;286.044999;1;74;0;74;100
shiftreg5-1;37029;520.839888;630.584408;1;339;0;339;100
shipsched;37029;0;2.147365;5;144;1;145;100
shipschedule3shipsi;37029;-265650;0;1;36;0;36;0
shipschedule6shipsmixi;37029;-301650;0;1;57;0;57;0
shipschedule8shipsmixuci;37029;-401100;0;1;70;1;71;0
shs1014;37029;22137.410363;391.180556;1;178707;9;178716;100
shs1042;37029;9455.525826;684.883411;1;68999;10;69009;100
siena1;37029;10163179.229002;146.859338;1;1635;0;1635;100
sing11;37029;18640171.224643;331.879469;1;8386;4;8390;100
sing161;37029;19071259.113927;996.464534;1;64044;19;64063;100
sing17;37029;35483848.876514;554.751047;1;30180;12;30192;100
sing2;37029;17150914.71694;252.506822;1;1705;0;1705;100
sing245;37029;25024015.754083;519.079791;1;11809;5;11814;100
sing326;37029;7717674.801189;203.886687;1;2723;1;2724;100
sing359;37029;22534478.962498;1259.613224;1;85755;18;85773;100
sing44;37029;8102513.2194;177.330369;1;3148;1;3149;100
sing5;37029;18418516.013137;272.410096;1;3483;3;3486;100
snip10x10-35r1budget17;37029;30;2.340909;1;493;0;493;100
snp-02-004-104;37029;548044802.97509;10.217187;2;4144;0;4144;100
snp-04-052-052;37029;728196432.049806;735.582559;2;3881;1;3882;100
snp-06-004-052;37029;1787138156.58097;33.734354;2;6599;1;6600;100
snp-10-004-052;37029;5842625068.20526;48.106063;2;14385;1;14386;100
snp-10-052-052;37029;5842626434.04626;1694.316668;2;16172;3;16175;100
sorrell3;37029;-11;0;3;701;10;711;31.25
sorrell4;37029;-16;0;3;2811;38;2849;33.33
sorrell7;37029;-150;0;3;399;5;404;23.47
sorrell8;37029;-260;0;3;91;1;92;25.71
sp150x300d;37029;71;0;2;1;0;1;2.9
sp97ar;37029;872846899.46;0;4;684;4;688;32.11
sp97ic;37029;640285470.4;0;4;395;5;400;49.71
sp98ar;37029;1129323150.12177;1.09976;3;643;0;643;100
sp98ic;37029;580906673.440001;0;4;360;4;364;29.34
sp98ir;37029;314133467.823746;8.320942;3;71;0;71;100
splice1k1;37029;-1646.777979;8.512635;1;16912;8;16920;100
splice1k1i;37029;-1654;0;1;199;6;205;0
square23;37029;8.333333;12.444444;1;145;0;145;100
square31;37029;8.5;13.75;1;805;0;805;100
square37;37029;8.666667;15;1;2303;1;2304;100
square41;37029;8.839612;15.068891;1;3754;1;3755;100
square47;37029;8.755814;15.976744;1;6462;2;6464;100
stoch-vrpvrp-s5v2c8vrp-v2c8i;37029;0;107;1;33;0;33;100
stockholm;37029;175;0;2;526;0;526;40
stp3d;37029;604.886283;537.229946;2;26251;7;26258;100
sts405;37029;357;0;3;535;2;537;0
sts729;37029;665;0;3;3143;6;3149;0
supportcase1;37029;20078;0.020624;2;284;3;287;100
supportcase10;37029;3.383924;1850.997936;1;9156;2;9158;100
supportcase12;37029;-7609.533054;54.777672;1;1429;1;1430;100
supportcase14;37029;272;9.894737;1;1;0;1;100
supportcase16;37029;272;9;1;1;0;1;100
supportcase17;37029;0;88.508268;2;10;0;10;100
supportcase18;37029;87;9.141806;2;47;0;47;100
supportcase19;37029;12677206;370.390975;1;27570;28;27598;100
supportcase2;37029;0;7.75;1;9557;0;9557;100
supportcase20;37029;2442.144012;4.88286;1;18;0;18;100
supportcase23;37029;-12952;674.436182;1;1626;0;1626;100
supportcase25;37029;0.036932;11.225059;1;111;0;111;100
supportcase26;37029;1288.102161;0.009948;2;1;0;1;100
supportcase27i;37029;0;0.028235;1;1;0;1;100
supportcase3;37029;0;754.600046;3;210;1;211;100
supportcase30;37029;0;102.85702;1;58;0;58;100
supportcase31;37029;-1120655.076;0;3;1860;70;1930;69.88
supportcase33;37029;-450.933468;67.82818;2;465;0;465;100
supportcase34;37029;72.664116;339.350876;1;1224;0;1224;100
supportcase35;37029;77847.333333;96;2;116;0;116;100
supportcase37;37029;-5865.764096;28.04048;2;867;0;867;100
supportcase39;37029;-1062330.369524;22.808785;5;106;1;107;100
supportcase4;37029;0;537.153071;3;178;0;178;100
supportcase40;37029;22536.483379;19;1;264;0;264;100
supportcase41;37029;28;23.62447;5;279;0;279;100
supportcase42;37029;7.343539;48.081295;1;1555;0;1555;100
supportcase43;37029;0;48.147044;2;44675;3;44678;100
supportcase6;37029;45090.732163;30.239669;1;1580;3;1583;100
supportcase7;37029;-2396.218213;53.14731;2;1960;0;1960;100
swath;37029;334.496858;2.2;1;43;0;43;100
swath1;37029;334.496858;0.6;1;34;0;34;100
swath2;37029;334.496858;0.7;1;38;0;38;100
swath3;37029;334.496858;0.8;1;36;0;36;100
t1717;37029;134531.021428;79.098998;1;282;1;283;100
t1722;37029;98815.407611;52.399108;1;151;0;151;100
ta1-UUM;37029;3693674.556772;4.190418;1;3;0;3;100
ta2-UUE;37029;41427354.755773;0.680983;2;152;0;152;100
tanglegram1;37029;0;146;1;245;1;246;100
tanglegram2;37029;0;74;1;39;0;39;100
tanglegram4;37029;0;214;1;826;1;827;100
tanglegram6;37029;0;100;1;62;0;62;100
tbfp-bigm;37029;-178.153988;30;1;259;0;259;100
tbfp-network;37029;23.261535;31;1;849;1;850;100
Test3;37029;2669532.692462;22.368722;2;261;0;261;100
thor50dday;37029;204179;0;2;252;4;256;100
timtab1;37029;1234321.333333;18.45;2;1;0;1;100
timtab1CUTS;37029;613590.095426;35.885811;2;4;0;4;100
timtab2;37029;1487304.333333;29.783333;2;1;0;1;100
tokyometro;37029;11100;243.797433;2;74;0;74;100
toll-like;37029;0;339.5;1;38;0;38;100
tpl-tub-ss16;37029;456084.544813;2148.906605;2;92308;27;92335;100
tpl-tub-ws1617;37029;404400.026245;2262.455897;2;120842;29;120871;100
tr12-30;37029;188435.464884;3.580258;2;3;0;3;100
traininstance2;37029;0;641.688695;2;56;0;56;100
traininstance6;37029;0;381.122112;2;44;0;44;100
transportmoment;37029;-70929535815.38;783.890174;2;234;0;234;100
trento1;37029;5182758.848056;76.426737;1;579;0;579;100
triptim1;37029;22.868088;2111.393837;1;9179;1;9180;100
triptim2;37029;10.866359;800.023299;1;10398;1;10399;100
triptim3;37029;13.511741;803.795145;1;10449;1;10450;100
triptim4;37029;9.207022;602.920956;1;12125;1;12126;100
triptim7;37029;2336.732602;589.654105;2;12342;2;12344;100
triptim8;37029;2336.754853;582.63451;2;13399;4;13403;100
tw-myciel4;37029;3.838028;125.746479;6;209;0;209;100
uc-case11;37029;611267.013003;118.157436;1;3011;0;3011;100
uc-case3;37029;7181.264177;95.341586;1;2089;0;2089;100
uccase10;37029;38988.693469;403.985961;1;2848;1;2849;100
uccase12;37029;11507.285324;38.32;1;2175;0;2175;100
uccase7;37029;26527.789654;162.379998;1;3577;0;3577;100
uccase8;37029;11142.163196;63.982247;1;2809;0;2809;100
uccase9;37029;10819.582997;76.021209;1;4261;0;4261;100
uct-subprob;37029;242;56.400387;1;47;0;47;100
umts;37029;91618146.215272;77.667697;2;51;0;51;100
unitcal_7;37029;19387712.348556;143.515421;2;814;0;814;100
usAbbrv-8-25_70;37029;95;142.568932;3;32;0;32;100
usafa;37029;11.961749;2930.074494;2;52215;30;52245;100
v150d30-2hopcds;37029;54;0;3;163;2;165;31.71
van;37029;1.72352;5.404444;1;2766;0;2766;100
var-smallemery-m6j6;37029;-156.056268;90.190835;2;1327;1;1328;100
vpm2;37029;13.372866;5.698001;2;1;0;1;100
vpphard;37029;0;126.795208;1;222;1;223;100
vpphard2;37029;0;224.687229;1;726;10;736;100
wachplan;37029;-9;59.730159;1;40;0;40;100
wnq-n100-mw99-14;37029;194.184211;80.973684;3;4823;1;4824;100
xmas10-2;37029;-548.904684;180.189643;1;210;0;210;100
xmas10;37029;-449.063962;131.814139;7;192;0;192;100
z26;37029;-982;0;3;2773;37;2810;17.27
zeil;37029;813.510308;818.357568;2;86455;9;86464;100
zib54-UUE;37029;19164366;0;2;50;0;50;85.45
