Instance;Seed;Cost;Fractionality;Rounds;LPtime(ms);ZItime(ms);LP+ZItime(ms);Gap(%)
10teams;37029;917;36.681642;1;33;0;33;100
22433;37029;21552.708079;24.962328;5;8;0;8;100
23588;37029;8342.863244;17.617619;4;4;0;4;100
2club200v15p5scn;37029;-96.055556;38.611111;7;120;4;124;100
30n20b8;37029;5530;15.589981;2;105;1;106;100
30_70_45_05_100;37029;105;0;5;812;2;814;100
30_70_45_095_100;37029;58;0;5;769;2;771;100
30_70_45_095_98;37029;375;0;6;862;4;866;100
50v-10;37029;1493601.476062;0;2;4;0;4;100
a1c1s1;37029;20912.873333;0.041667;2;32;0;32;100
a2c1s1;37029;20866.0825;0;2;40;0;40;91.62
ab51-40-100;37029;-6461729251;0;3;870;1;871;37.99
ab67-40-100;37029;-7069213256;0;3;2619;1;2620;36.8
ab69-40-100;37029;-7004957456.99999;0;3;2041;1;2042;37.38
ab71-20-100;37029;-6510510462;0;3;213;1;214;37.52
ab72-40-100;37029;-6898618453.00001;0;3;766;1;767;38.33
academictimetablebig;37029;57;2027.119953;2;3231;20;3251;100
academictimetablesmall;37029;0;327.222248;2;227;3;230;100
acc-tight2;37029;0;129.034401;1;33;0;33;100
acc-tight4;37029;0;133.878393;1;60;0;60;100
acc-tight5;37029;0;121.269585;1;255;0;255;100
acc-tight6;37029;0;120.058761;1;241;0;241;100
adult-max5features;37029;0.081316;0.266955;1;886;3;889;100
adult-regularized;37029;0.077684;0.234052;1;2059;3;2062;100
aflow30a;37029;983.167425;6.510845;1;5;0;5;100
aflow40b;37029;1005.664817;8.247724;1;19;0;19;100
air03;37029;338864.25;11.875;1;66;0;66;100
air04;37029;55535.436388;52.288553;1;229;0;229;100
air05;37029;25877.609268;46.215654;1;145;0;145;100
aligninq;37029;2755;40.921868;7;15;0;15;100
allcolor10;37029;6;755.781169;2;155;1;156;100
allcolor58;37029;42;3660.566767;1;1256;5;1261;100
amaze22012-03-15i;37029;0;0;1;44;1;45;0
amaze22012-06-28i;37029;0;0;1;23;0;23;0
amaze22012-07-04i;37029;0;0;1;26;0;26;0
app1-1;37029;-2;0.179678;3;61;0;61;100
app1-2;37029;-23;1e-06;2;3812;1;3813;100
app2-1;37029;19298.5;0;2;35;0;35;0.02
app2-2;37029;219402.5;0;3;1;0;1;3.47
app3;37029;5627412.287938;3.142492;1;41;0;41;100
arki001;37029;7579599.807787;17.164714;1;32;0;32;100
assign1-10-4;37029;353.992926;52;1;42;0;42;100
assign1-5-8;37029;183.362555;24;1;2;0;2;100
atlanta-ip;37029;81.243206;325.689509;3;4387;10;4397;100
atm20-100;37029;2141734.684878;124.301066;2;86;0;86;100
australia-abs-cta;37029;0;38.750723;1;96;0;96;100
b-ball;37029;-1.818182;4.818182;1;0;0;0;100
b1c1s1;37029;69966.45;0;2;33;0;33;100
b2c1s1;37029;70651.01;0;2;41;0;41;100
bab1;37029;-286923.824223;50.52;1;256;5;261;100
bab2;37029;-353606.266494;534.575488;2;8522;27;8549;100
bab3;37029;-557391.946196;518.63538;2;31142;47;31189;100
bab5;37029;-111176.514726;175.63525;2;519;2;521;100
bab6;37029;-224575.783183;661.616846;2;6044;19;6063;100
bc;37029;13.063318;0.063318;2;101;0;101;100
bc1;37029;6.45558;0.016336;2;104;0;104;100
beasleyC1;37029;102;0;2;2;0;2;20
beasleyC2;37029;232;0;2;2;0;2;61.11
beasleyC3;37029;958;0;2;3;0;3;27.06
beavma;37029;407840.4;0;3;1;0;1;6.41
berlin;37029;1741;0;2;28;0;28;66.76
berlin_5_8_0;37029;52;64.959947;3;9;0;9;100
bg512142;37029;323992.007013;52.989642;3;28;0;28;100
biella1;37029;3060037.430763;98.771008;1;248;0;248;100
bienst1;37029;11.724138;4.390524;1;2;0;2;100
bienst2;37029;11.724138;5.390524;1;2;0;2;100
binkar10_1;37029;6637.188027;9.084811;1;8;0;8;100
blend2;37029;7.489992;0.492283;2;0;0;0;100
bley_xl1;37029;265.571332;336.926676;6;23245;24;23269;100
bley_xs1;37029;213538830.272187;107.27048;3;150;0;150;100
bley_xs1noM;37029;251120149.512445;78.38821;8;117;1;118;100
bley_xs2;37029;48593009.277766;66.02141;2;26;0;26;100
blp-ar98;37029;14303.194003;9.189386;9;106;17;123;100
blp-ic97;37029;6123.238237;3.473359;16;87;18;105;100
blp-ic98;37029;14141.050706;0.1;4;245;24;269;100
blp-ir98;37029;5639.818879;2.497817;2;52;2;54;100
bmocbd;37029;-32041010095048.5;0;1;948;7;955;0
bmocbd2;37029;-31953009810558.2;0;1;1023;11;1034;0
bmocbd3;37029;45423160355.8175;0;2;17508;11;17519;100
bmoipr2;37029;-46628940.711141;0.160693;3;82;1;83;100
bnatt350;37029;0;91.914943;4;76;0;76;100
bnatt400;37029;0;98.918149;7;70;1;71;100
bppc4-08;37029;51.59;8.850948;1;18;0;18;100
bppc6-02;37029;108.34;11.886994;1;142;0;142;100
bppc6-06;37029;200.633333;14.947367;1;168;0;168;100
bppc8-02;37029;486.5;3.204377;1;1;0;1;100
bppc8-09;37029;444.436047;5.98123;1;4;0;4;100
brasil;37029;31819;0;2;28;0;28;100
brazil3;37029;2;656.675844;1;1099;1;1100;100
breastcancer-regularized;37029;0.00046;0.002809;1;7;0;7;100
bts4-cta;37029;33524.637606;1130;1;611;0;611;100
buildingenergy;37029;33246.215059;1468.85;2;16129;4;16133;100
cap6000;37029;-2446875;0;3;43;1;44;0.18
cbs-cta;37029;0;28.754656;1;128;0;128;100
cdc7-4-3-2;37029;-231;0;3;37381;7;37388;19.79
chromaticindex1024-7;37029;4;16002.682953;2;2516;11;2527;100
chromaticindex128-5;37029;4;2021.163699;2;153;1;154;100
chromaticindex256-8;37029;4;4069.477083;2;472;3;475;100
chromaticindex32-8;37029;4;504.8875;2;22;0;22;100
chromaticindex512-7;37029;4;8183.527137;2;1149;5;1154;100
ci-s4;37029;4.963809;19.526141;2;66;0;66;100
circ10-3;37029;140;154.207692;1;179;1;180;100
cmflsp40-24-10-7;37029;52605868.952858;70.70093;3;361;0;361;100
cmflsp40-36-2-10;37029;72898024.959478;295.649246;3;904;0;904;100
cmflsp50-24-10-4;37029;64492612.641644;81.236085;3;344;0;344;100
cmflsp50-24-8-8;37029;59814378.749021;131.86946;3;344;0;344;100
cmflsp60-36-2-6;37029;97887903.946142;370.689759;3;1810;0;1810;100
CMS750_4;37029;250;258.046726;3;113;1;114;100
co-100;37029;1250429.774879;9.799423;2;274;20;294;100
cod105;37029;-8;0;3;468;1;469;33.33
comp07-2idx;37029;0;139.65;2;1572;2;1574;100
comp08-2idx;37029;0;183.178592;3;201;2;203;100
comp12-2idx;37029;11;249.122949;3;1362;2;1364;100
comp16-3idx;37029;4;722.299516;1;8119;2;8121;100
comp21-2idx;37029;0;197.95;2;949;1;950;100
control30-3-2-3;37029;-20763026.787568;27.97054;1;5;0;5;100
core2536-691;37029;797;0;3;1423;3;1426;15.67
core2586-950;37029;1164;0;3;871;3;874;22.78
core4284-1064;37029;1303;0;3;4744;5;4749;22.58
core4872-1529;37029;1837;0;3;2799;5;2804;20.07
cost266-UUE;37029;42001606.28;0;2;87;0;87;67.01
cov1075;37029;35;0;2;5;0;5;75
cryptanalysiskb128n5obj16;37029;0;7174.215397;2;941;7;948;100
csched007;37029;269.251587;22.185714;1;37;0;37;100
csched008;37029;171;19.809478;1;11;0;11;100
csched010;37029;332.422727;20.035354;1;33;0;33;100
cvrpa-n64k9vrpi;37029;0;211.276596;1;363;3;366;100
cvrpb-n45k5vrpi;37029;0;153.312977;1;166;1;167;100
cvrpp-n16k8vrpi;37029;0;50.625;1;31;0;31;100
cvrpsimple2i;37029;0;25.8;1;2;0;2;100
cvs08r139-94;37029;-24;0;3;14;0;14;79.31
cvs16r106-72;37029;-10;0;3;32;0;32;87.65
cvs16r128-89;37029;-11;0;3;35;0;35;88.66
cvs16r70-62;37029;-5;0;3;30;0;30;88.1
cvs16r89-60;37029;-7;0;3;30;0;30;89.23
d10200;37029;12425.583005;34.236879;1;48;0;48;100
d20200;37029;12229.625788;62.339279;1;303;0;303;100
dale-cta;37029;0;0.00473;1;275;0;275;100
dano3mip;37029;576.23162;15.294513;1;1744;0;1744;100
dano3_3;37029;576.23162;1.932181;1;1799;0;1799;100
dano3_5;37029;576.23162;2.871834;1;1661;0;1661;100
danoint;37029;62.63728;5.819184;1;15;0;15;100
dc1c;37029;1754946.863638;139.779852;1;283;0;283;100
dc1l;37029;203610672.021484;0;3;1323;17;1340;100
dcmulti;37029;184858.396836;12.823814;3;3;0;3;100
decomp1;37029;-120;98.888889;1;47;0;47;100
decomp2;37029;-160;93.138889;1;53;0;53;100
dfn-bwin-DBE;37029;797567.4;0;2;36;0;36;100
dfn-gwin-UUM;37029;27467.257235;5.653537;1;1;0;1;100
dg012142;37029;5895516.340434;39.442147;5;193;0;193;100
diameterc-mstc-v20a190d5i;37029;291;62;1;37;0;37;100
diameterc-msts-v40a100d5i;37029;324;100.621212;1;33;0;33;100
disctom;37029;-5000;51.166667;1;214;0;214;100
disktom;37029;-5000;51.166667;1;208;0;208;100
dolom1;37029;6556066.068315;110.72091;1;470;1;471;100
drayage-100-12;37029;21458.311901;43.599962;1;59;0;59;100
drayage-100-23;37029;11714.141979;43.32781;1;135;0;135;100
drayage-25-23;37029;11714.141979;42.142735;1;144;0;144;100
drayage-25-27;37029;26785.797043;43.712602;1;57;0;57;100
drayage-25-32;37029;32519.997253;43.268141;1;62;0;62;100
ds-big;37029;86.820068;30.669231;1;8268;24;8292;100
ds;37029;57.234565;33.463549;1;1051;8;1059;100
dws008-01;37029;708.876687;16.484655;2;72;0;72;100
dws008-03;37029;716.047081;7.806469;2;150;2;152;100
dws012-01;37029;3473.575073;26.230322;2;142;1;143;100
dws012-02;37029;2128.039491;19.344808;2;251;3;254;100
dws012-03;37029;2125.884828;18.678617;2;364;4;368;100
eil33-2;37029;811.278996;3.61563;1;40;0;40;100
eilA101-2;37029;803.373888;7.408683;1;959;7;966;100
eilB101;37029;1075.247691;12.807028;1;22;0;22;100
eilC76-2;37029;725.754458;7.780208;1;322;2;324;100
ej;37029;1;0.243844;1;0;0;0;100
elitserienhandball11i;37029;0;1421.352265;1;288;1;289;100
elitserienhandball13i;37029;0;1357.692232;1;290;1;291;100
elitserienhandball14i;37029;0;1543.7577;1;245;1;246;100
elitserienhandball3i;37029;0;1525.315516;1;254;1;255;100
enlight13;37029;0;0.5;1;0;0;0;100
enlight15;37029;0;0.5;1;0;0;0;100
enlight8;37029;0;0.5;1;0;0;0;100
enlight_hard;37029;0;14.5;1;0;0;0;100
eva1aprime5x5opt;37029;-497.247729;0.844656;1;422;0;422;100
eva1aprime6x6opt;37029;-495.49243;7.714269;1;2008;0;2008;100
ex10;37029;100;100;1;17196;7;17203;100
ex1010-pi;37029;314;0;3;711;4;715;33.62
ex9;37029;81;81;1;1734;3;1737;100
exp-1-500-5-5;37029;97666.305541;4.045842;2;2;0;2;100
f2000;37029;1383;1280;2;3545;0;3545;100
f2gap201600;37029;76429.862296;1.402159;1;3;0;3;100
f2gap401600;37029;82274.237434;1.19002;1;3;0;3;100
f2gap40400;37029;20650.898154;3.25358;1;1;0;1;100
f2gap801600;37029;86570.120867;5.266841;1;5;0;5;100
fast0507;37029;221;0;3;567;10;577;27.01
fastxgemm-n2r6s0t2;37029;27;9;1;30;0;30;100
fastxgemm-n2r7s4t1;37029;27;9;1;32;0;32;100
fastxgemm-n3r21s3t6;37029;84;27;1;2360;0;2360;100
fastxgemm-n3r22s4t6;37029;84;27;1;2653;0;2653;100
fastxgemm-n3r23s5t6;37029;84;27;1;2591;0;2591;100
fhnw-binpack4-48;37029;0;333.285714;2;132;0;132;100
fhnw-binpack4-58;37029;0;467.321429;2;137;1;138;100
fhnw-binpack4-77;37029;0;207.310714;2;107;0;107;100
fhnw-binschedule0;37029;12632.888779;685.581929;3;11277;39;11316;100
fhnw-binschedule2;37029;1706.886254;185.026392;3;186;3;189;100
fhnw-schedule-paira100;37029;-36.643681;5.147307;2;126;0;126;100
fhnw-schedule-paira200;37029;-73.826479;8.938667;2;279;2;281;100
fhnw-schedule-paira400;37029;-146.941079;19.26431;2;1435;10;1445;100
fhnw-schedule-pairb200;37029;-73.826479;516.184695;2;1102;6;1108;100
fhnw-schedule-pairb400;37029;-146.941079;2338.646383;2;7148;24;7172;100
fhnw-sq2;37029;0;14.298419;1;4;0;4;100
fiball;37029;137.069168;82.028566;1;136;1;137;100
fiber;37029;1023943.76;9.839127;2;3;0;3;100
fillomino7x7-0i;37029;0;0;1;30;0;30;0
fixnet6;37029;12170;0;2;1;0;1;100
fjspeasy01i;37029;216;0;1;44;0;44;0
flugpl;37029;1167185.725592;3.538918;1;0;0;0;100
g200x740;37029;45614;0;2;2;0;2;2.93
g200x740i;37029;44069;0;2;2;0;2;46.48
gasprod1-1;37029;4539.90753;51.5198;7885;772;6460;7232;100
gasprod1-2;37029;1691.141291;51.497411;6853;574;4663;5237;100
gasprod1-3;37029;3682.336923;49.221179;8368;540;5866;6406;100
gasprod2-1;37029;1306101.609201;404.201103;19;1773;17;1790;100
gasprod2-2;37029;1330631.091637;502.800224;36;1715;33;1748;100
gen-ip002;37029;-511.036897;0;3;0;0;0;89.32
gen-ip016;37029;-9505.628173;1.906914;1;0;0;0;100
gen-ip021;37029;6642.05262;2.217259;4;0;0;0;100
gen-ip036;37029;-2162.833562;0;3;0;0;0;53.05
gen-ip054;37029;16786.476526;1.032398;5;0;0;0;100
gen;37029;112130.040664;7.929263;1;3;0;3;100
genus-g31-8;37029;-27;83;1;1087;1;1088;100
genus-g61-25;37029;-58;249.312678;1;681;2;683;100
genus-sym-g31-8;37029;-27;154.805251;2;3947;3;3950;100
genus-sym-g62-2;37029;-54;251.108763;2;22550;3;22553;100
genus-sym-grafo5708-48;37029;-27;115.061005;1;1397;0;1397;100
ger50-17-ptp-pop-3t;37029;3466.324873;45.213645;1;98;0;98;100
ger50-17-ptp-pop-6t;37029;6804.447088;50.477969;1;97;0;97;100
ger50-17-trans-dfn-3t;37029;3453.475245;37.741927;1;175;1;176;100
ger50-17-trans-pop-3t;37029;3456.252922;49.487013;1;166;2;168;100
ger50_17_trans;37029;6850.628623;48.22611;1;168;1;169;100
germanrr;37029;46445702.956442;53.468182;2;799;5;804;100
germany50-DBM;37029;438028;23.4;1;139;0;139;100
germany50-UUM;37029;597932.5;24.4;1;39;0;39;100
gesa2-o;37029;25748173.191117;13.380406;2;5;0;5;100
gesa2;37029;25477017.874283;13.26737;2;8;0;8;100
gfd-schedulen180f7d50m30k18-16i;37029;18;108.864749;1;5832;92;5924;100
gfd-schedulen180f7d50m30k18;37029;1;4971.136881;2;3493;24;3517;100
gfd-schedulen25f5d20m10k3i;37029;3;13.619895;1;67;1;68;100
gfd-schedulen55f2d50m30k3i;37029;3;27.695911;1;164;2;166;100
ghoulomb4-9-10i;37029;9;0;1;64;1;65;0
glass-sc;37029;23;0;3;115;1;116;0
glass4;37029;800002400;2.059524;1;1;0;1;100
gmu-35-40;37029;-2400283.756506;1.911023;2;9;0;9;100
gmu-35-50;37029;-2606307.146543;3.420099;2;20;0;20;100
gmut-75-50;37029;-14182312.661731;4.988967;1;613;6;619;100
gmut-76-40;37029;-14171086.316075;9.054451;1;226;1;227;100
gmut-76-50;37029;-14173884.188063;4.201959;1;460;4;464;100
gmut-77-40;37029;-14173396.636852;2.97325;1;233;1;234;100
go19;37029;96;0;3;4;0;4;14.29
gr4x6;37029;229.05;0;2;0;0;0;13.19
graph20-20-1rand;37029;-37;48.5;1;57;0;57;100
graph20-80-1rand;37029;-117;142;1;1750;1;1751;100
graph40-20-1rand;37029;-157;183.5;1;3916;3;3919;100
graph40-40-1rand;37029;-300;327;1;90678;9;90687;100
graphdraw-domain;37029;12672;18.037296;1;2;0;2;100
graphdraw-gemcutter;37029;4310;10.690226;1;1;0;1;100
graphdraw-grafo2;37029;35762;325.965485;1;769;3;772;100
graphdraw-mainerd;37029;30496;102.656285;1;78;0;78;100
graphdraw-opmanager;37029;54717;178.181738;1;439;1;440;100
gsvm2rl11;37029;35640.343493;0;2;343;0;343;96.67
gsvm2rl12;37029;50;0;2;562;0;562;100
gsvm2rl3;37029;0.6;0;2;3;0;3;78.29
gsvm2rl5;37029;10;0;2;8;0;8;84.4
gsvm2rl9;37029;16356.825869;0;2;57;0;57;100
gt2;37029;13460.233074;0.728107;1;0;0;0;100
h50x2450;37029;11147.731511;3.696751;1;32;0;32;100
h80x6320;37029;3700;0;1;24;0;24;0
h80x6320d;37029;5325.160104;2.515625;1;40;0;40;100
hanoi5;37029;1931;324;4;157;1;158;100
haprp;37029;3665963.213506;96.940858;1;5;0;5;100
harp2;37029;-74353341.5023;5.485338;1;7;0;7;100
hgms-det;37029;-53824.391476;32.676364;1;219;0;219;100
hgms30;37029;-53349.215497;60.694272;1;9372;0;9372;100
hgms62;37029;-53416.649907;61.317531;1;27241;0;27241;100
hypothyroid-k1;37029;-2902.852586;39.591978;1;7424;2;7426;100
ic97_potential;37029;4060;54.466667;2;4;0;4;100
ic97_tension;37029;3911;15.366667;2;2;0;2;100
icir97_potential;37029;6620;169.333333;2;63;0;63;100
icir97_tension;37029;6302;97.366667;2;4;0;4;100
iis-100-0-cov;37029;41;0;3;110;0;110;41.38
iis-bupa-cov;37029;49;0;3;167;1;168;36.11
iis-glass-cov;37029;28;0;3;140;1;141;33.33
iis-hc-cov;37029;22;0;3;195;3;198;29.41
iis-pima-cov;37029;41;0;3;228;1;229;24.24
irp;37029;12123.530222;6;1;83;1;84;100
istanbul-no-cutoff;37029;51.11;3.607411;1;402;0;402;100
ivu06-big;37029;135.427718;95.799872;1;55601;177;55778;100
ivu06;37029;135.901353;97.120377;1;15356;55;15411;100
ivu52;37029;480.250439;83.13028;1;7184;15;7199;100
ivu59;37029;884.456993;122.834601;1;108091;228;108319;100
janos-us-DDM;37029;1488134.75;22.375;1;5;0;5;100
k16x240;37029;11359;0;2;1;0;1;6.42
k16x240b;37029;12874;0;2;0;0;0;13
k1mushroom;37029;-4165.061224;43.877551;1;16851;7;16858;100
k1mushroomi;37029;-4208;0;1;187;6;193;0
khb05250;37029;126785464;0;2;2;0;2;18.56
l2p12;37029;2;1084.341227;1;363;0;363;100
l2p1i;37029;1;186.848182;1;843;16;859;100
l2p2i;37029;1;9.888081;1;60;1;61;100
lectsched-1-obj;37029;0;5.975758;2;234;6;240;100
lectsched-1;37029;0;3.151515;2;207;6;213;100
lectsched-2;37029;0;17.32803;5;117;8;125;100
lectsched-3;37029;0;25.257576;6;202;13;215;100
lectsched-4-obj;37029;0;12.074242;4;58;2;60;100
lectsched-5-obj;37029;0;4.117424;2;191;4;195;100
leo1;37029;1181219706.24;0;3;75;2;77;100
leo2;37029;1344214233.44;0;3;195;4;199;100
liu;37029;346;10.938399;2;6;0;6;100
loopha13;37029;6.279;1.10216;2;199;1;200;100
lotsize;37029;1335747.052789;7.405615;2;6;0;6;100
lr1dr02vc05v8a-t360;37029;120706.326475;174.298112;1;900;1;901;100
lr1dr04vc05v17a-t360;37029;247111.69248;335.090553;1;1757;2;1759;100
lr1dr12vc10v70b-t360;37029;983950.247945;1069.593454;1;43146;11;43157;100
lr2-22dr3-333vc4v17a-t60;37029;-72838.215835;239.748662;2;36931;8;36939;100
lrn;37029;42701141.648089;65.099086;2;467;0;467;100
m100n500k4r1;37029;-17;0;3;6;0;6;32
macrophage;37029;0;339;1;33;0;33;100
mad;37029;0;3.084841;1;1;0;1;100
manna81;37029;-11868;0;3;36;0;36;9.85
map06;37029;-406.181173;7.868443;1;2238;1;2239;100
map10;37029;-602.176181;11.248146;1;2392;1;2393;100
map14;37029;-778.549324;11.962355;1;2124;1;2125;100
map14860-20;37029;-998.836419;10.400693;1;2578;1;2579;100
map16715-04;37029;-296.267898;4.997036;1;2412;1;2413;100
map18;37029;-932.782685;11.173489;1;4195;1;4196;100
map20;37029;-998.836419;10.400693;1;2572;1;2573;100
mappingmesh3x3mpeg2i;37029;87.555556;87.202393;1;34;0;34;100
mario-t-hard5i;37029;-4482;10.942559;1;1551;3;1554;100
markshare1;37029;230;0;2;0;0;0;100
markshare2;37029;454;0;2;0;0;0;100
markshare_4_0;37029;226;0;2;0;0;0;100
markshare_5_0;37029;337;0;2;0;0;0;100
mas74;37029;10482.79528;3.103514;1;1;0;1;100
mas76;37029;38893.903641;2.555097;1;1;0;1;100
maxgasflow;37029;-70929535.9;647.128713;2;57;0;57;100
mc11;37029;13509;0;2;29;0;29;15.57
mc7;37029;5796;0;2;31;0;31;69.62
mc8;37029;1929;0;2;31;0;31;23.18
mcsched;37029;193774.753707;340.221655;1;134;0;134;100
methanosarcina;37029;0;313;1;104;0;104;100
mik-250-1-100-1;37029;0;0;2;2;0;2;100
mik-250-20-75-1;37029;0;0;2;3;0;3;100
mik-250-20-75-2;37029;0;0;2;3;0;3;100
mik-250-20-75-3;37029;0;0;2;3;0;3;100
mik-250-20-75-4;37029;0;0;2;3;0;3;100
mik-250-20-75-5;37029;0;0;2;3;0;3;100
milo-v12-6-r1-58-1;37029;410986.648167;146.256423;1;160;0;160;100
milo-v12-6-r1-75-1;37029;669700.757896;230.843427;1;209;0;209;100
milo-v12-6-r2-40-1;37029;205532.322265;97.799498;1;73;0;73;100
milo-v13-4-3d-3-0;37029;23359.288017;1.476277;1;13;0;13;100
milo-v13-4-3d-4-0;37029;34031.171805;2.550972;1;22;0;22;100
mine-166-5;37029;-821763677.673139;187.331384;1;211;0;211;100
mine-90-10;37029;-887165318.510226;202.375368;1;168;0;168;100
mining;37029;-885962268.692866;8562.753844;62;108225;1683;109908;100
minutedispatchstrategy;37029;1898.391429;412.137934;2;1131;2;1133;100
misc07;37029;1415;8;1;2;0;2;100
mitre;37029;114740.518481;224.156743;1;101;0;101;100
mkc;37029;-581.85;16.208843;3;29;0;29;100
mkc1;37029;-611.85;3.942199;3;31;0;31;100
mod010;37029;6532.083333;14.166667;1;14;0;14;100
modglob;37029;20786787.016883;0;2;2;0;2;0.22
moj-mining;37029;-1520532907.35018;566.626558;2;46353;0;46353;100
momentum1;37029;134660.011921;48.045264;2;1004;0;1004;100
momentum2;37029;61266.821316;84.616225;3;738;2;740;100
momentum3;37029;107721.82427;144.721031;3;8340;1;8341;100
mrcpspj30-15-5i;37029;23;136.179484;1;60;0;60;100
mrcpspj30-17-10i;37029;25;28.677778;1;44;0;44;100
mrcpspj30-53-3i;37029;30;39.081217;1;40;0;40;100
msc98-ip;37029;19520966.151663;338.886443;2;4365;2;4367;100
mspp16;37029;341;1.241379;1;27237;156;27393;100
mspsphard01i;37029;16;0;1;46;0;46;0
mspsphard03i;37029;20;0;1;88;1;89;0
mtest4ma;37029;60342;0;2;1;0;1;15.71
mushroom-best;37029;1.3e-05;0.0192;1;354;1;355;100
mzzv11;37029;-22556.460829;174.328454;2;406;1;407;100
mzzv42z;37029;-18842.814586;198.473995;2;279;1;280;100
n13-3;37029;14401970;0;2;30;0;30;100
n15-3;37029;71710891;0;2;3304;0;3304;0
n2seq36f;37029;71600;0;3;35;1;36;37.16
n2seq36q;37029;101037.6;28.84;3;156;3;159;100
n3-3;37029;24003430;0;2;134;0;134;100
n3700;37029;1342560;0;2;27;0;27;9.36
n3705;37029;1342540;0;2;29;0;29;9.55
n3707;37029;1301218;0;2;28;0;28;9.65
n3709;37029;1324904;0;2;29;0;29;9.68
n370a;37029;1353042;0;2;30;0;30;0
n370b;37029;1373791;0;2;30;0;30;11.06
n3div36;37029;174200;0;3;143;6;149;33.18
n3seq24;37029;189433.068485;51.670786;3;2961;59;3020;100
n4-3;37029;13501875;0;2;50;0;50;100
n5-3;37029;12301325;0;2;18;0;18;100
n6-3;37029;16502900;0;2;45;0;45;100
n7-3;37029;14704310;0;2;39;0;39;100
n9-3;37029;21603625;0;2;175;0;175;100
nag;37029;465;14.734996;3;45;0;45;100
neos-1061020;37029;-145860.370608;501.179054;1;992;0;992;100
neos-1067731;37029;669053;81.272727;1;502;0;502;100
neos-1109824;37029;278;22;1;60;0;60;100
neos-1112782;37029;22000000110147.3;0;2;27;0;27;100
neos-1112787;37029;19500000125389.7;0;2;22;0;22;100
neos-1122047;37029;162.181757;1.265657;2;498;0;498;100
neos-1171448;37029;-309;0.936995;2;79;0;79;100
neos-1171692;37029;-273;3.730892;2;39;0;39;100
neos-1171737;37029;-195;8.004699;2;59;0;59;100
neos-1225589;37029;5e+09;0;2;1;0;1;100
neos-1311124;37029;-182;5;2;4;0;4;100
neos-1324574;37029;4.5;144;1;35;0;35;100
neos-1330346;37029;4.5;76.5;1;123;0;123;100
neos-1337307;37029;-201272;272.493985;2;51;0;51;100
neos-1354092;37029;46;238.398385;2;1053;2;1055;100
neos-1367061;37029;31320456.264497;4.625;2;2242;1;2243;100
neos-1396125;37029;3000.053717;12.531496;2;7;0;7;100
neos-1420546;37029;22124.4;103.140678;1;377;0;377;100
neos-1420790;37029;2942.750002;75.132359;1;53;0;53;100
neos-1423785;37029;-1816.666667;311.9714;1;243;0;243;100
neos-1425699;37029;3175204364.6353;5.264952;1;0;0;0;100
neos-1426635;37029;-178;6.429182;2;2;0;2;100
neos-1426662;37029;-52;10.501303;2;4;0;4;100
neos-1429212;37029;30;702.979352;1;5721;14;5735;100
neos-1430701;37029;-78;6.669599;2;2;0;2;100
neos-1436709;37029;-129;3.502607;2;3;0;3;100
neos-1440225;37029;36;32.95203;1;124;0;124;100
neos-1440460;37029;-180;4.85975;2;2;0;2;100
neos-1442119;37029;-182;2.580471;2;4;0;4;100
neos-1442657;37029;-156;4.002933;2;3;0;3;100
neos-1445532;37029;-22860;8.21746;2;91;0;91;100
neos-1445738;37029;-24232.548846;16.549339;1;145;0;145;100
neos-1445743;37029;-24579.832968;16.952539;1;154;0;154;100
neos-1445765;37029;-24699.19766;17.463301;1;160;0;160;100
neos-1456979;37029;154;8.434222;1;41;0;41;100
neos-1516309;37029;34769.833333;9.166667;2;32;0;32;100
neos-1582420;37029;88.469527;56.693409;5;96;1;97;100
neos-1593097;37029;4424;55.795872;1;105;1;106;100
neos-1599274;37029;32194.742857;6.464286;3;53;1;54;100
neos-1601936;37029;1;160.240666;1;723;0;723;100
neos-1603965;37029;619244367.662955;0.000913;1;644;0;644;100
neos-1605061;37029;6.150735;155.194245;1;2218;0;2218;100
neos-1605075;37029;3.214461;172.430143;1;2315;0;2315;100
neos-1616732;37029;174;0;3;6;0;6;9.43
neos-1620770;37029;22;35;2;44;0;44;100
neos-2294525-abba;37029;156.177251;16.374339;1;92;0;92;100
neos-2328163-agri;37029;26069;48.333333;1;66;0;66;100
neos-2624317-amur;37029;0;24.102739;1;3;0;3;100
neos-2629914-sudost;37029;39622;6.805742;1;214;0;214;100
neos-2652786-brda;37029;0;23.382167;2;2;0;2;100
neos-2657525-crna;37029;0;28.348834;2;2;0;2;100
neos-2669500-cust;37029;2221.9;230.19862;2;997;17;1014;100
neos-2746589-doon;37029;1985.75;129.965898;2;319;6;325;100
neos-2974461-ibar;37029;473452396.770997;3364;2;220657;32;220689;100
neos-2978193-inde;37029;-2.418518;7.4;1;67;0;67;100
neos-2978205-isar;37029;-12.415307;28.8;1;204;0;204;100
neos-2987202-jeir;37029;-1847551552.23661;1035.632796;2;67629;1;67630;100
neos-2987310-joes;37029;-610797465.676974;19.875;2;1121;0;1121;100
neos-2991472-kalu;37029;441.200405;3.938339;5;4146;281;4427;100
neos-3004026-krka;37029;0;832;1;50;0;50;100
neos-3009394-lami;37029;0.642857;216.285714;1;4;0;4;100
neos-3024952-loue;37029;22882;103.3;1;262;0;262;100
neos-3025225-shelon;37029;0.052574;323.690533;1;100256;49;100305;100
neos-3046601-motu;37029;185;0.4492;1;1;0;1;100
neos-3046615-murg;37029;192;0.3458;1;1;0;1;100
neos-3048764-nadi;37029;-3883988306.36669;0;2;46;0;46;0
neos-3065804-namu;37029;0;0;1;193;0;193;0
neos-3068746-nene;37029;77427529.530929;55.412658;2;136;0;136;100
neos-3072252-nete;37029;10593526;1.938794;2;1;0;1;100
neos-3075395-nile;37029;54.924463;0.00048;1;156;0;156;100
neos-3083784-nive;37029;0;12;1;25;0;25;100
neos-3083819-nubu;37029;6290575.552807;13.541087;1;50;0;50;100
neos-3116779-oban;37029;0;0;1;22;0;22;0
neos-3118745-obra;37029;357;0;2;3;0;3;40
neos-3148108-pahi;37029;0;0;1;265;2;267;0
neos-3209462-rhin;37029;0;49.45122;2;4288;1;4289;100
neos-3209519-ruhr;37029;332.85;25.900482;1;54;0;54;100
neos-3214367-sovi;37029;87802.732596;100.08443;1;1911;0;1911;100
neos-3216931-puriri;37029;58817.353066;51.40019;1;1039;0;1039;100
neos-3226448-wkra;37029;0;512.043709;1;767;0;767;100
neos-3237086-abava;37029;0;96;1;295;2;297;100
neos-3322547-alsek;37029;616;115.178534;2;10351;72;10423;100
neos-3352863-ancoa;37029;495300;0;2;731;10;741;100
neos-3354841-apure;37029;48447.926267;4.407066;1;2775;26;2801;100
neos-3355120-tarago;37029;-20453473.616781;80.899969;1;669;2;671;100
neos-3355323-arnon;37029;0;33.818182;4;99;3;102;100
neos-3372571-onahau;37029;0.57699;8.695953;2;1686;0;1686;100
neos-3373491-avoca;37029;21687686014.0154;26.555947;1;7;0;7;100
neos-3381206-awhea;37029;432;61.334767;2;5;0;5;100
neos-3402294-bobin;37029;0;39.298587;1;1159;10;1169;100
neos-3426085-ticino;37029;235;41.78747;3;52;0;52;100
neos-3426132-dieze;37029;427;103.670666;2;55;0;55;100
neos-3437289-erdre;37029;0;0;1;93;1;94;0
neos-3530903-gauja;37029;170;33.253136;3;5;0;5;100
neos-3530905-gaula;37029;153;29.042208;2;4;0;4;100
neos-3555904-turama;37029;-41.45;29;1;904;5;909;100
neos-3572885-glina;37029;0;0;1;411;3;414;0
neos-3581454-haast;37029;1640;52;1;115;0;115;100
neos-3592146-hawea;37029;7237144.855333;13.694653;1;47;0;47;100
neos-3594536-henty;37029;383205;2498;1;167;1;168;100
neos-3603137-hoteo;37029;0;38.166667;3;55;1;56;100
neos-3610040-iskar;37029;46;0;2;3;0;3;24.32
neos-3610051-istra;37029;64;0;2;11;0;11;30.61
neos-3610173-itata;37029;180;0;2;7;0;7;21.62
neos-3611447-jijia;37029;129;0;2;3;0;3;20.56
neos-3611689-kaihu;37029;151;0;2;3;0;3;26.89
neos-3615091-sutlej;37029;-1506391.117177;170;1;1808;10;1818;100
neos-3627168-kasai;37029;1020229.4;0;2;4;0;4;3.2
neos-3634244-kauru;37029;0;152.72;1;4451;8;4459;100
neos-3636886-kereu;37029;4092.95754;2e-05;2;57;1;58;100
neos-3656078-kumeu;37029;-18774.7;92.164195;2;204;1;205;100
neos-3660371-kurow;37029;286.534383;17.739294;1;35;0;35;100
neos-3661949-lesse;37029;688975700;0.00026;2;50;0;50;100
neos-3665875-lesum;37029;248.325;41.380444;2;64;0;64;100
neos-3682128-sandon;37029;79915933.274829;141.641588;2;297;0;297;100
neos-3691541-lonja;37029;-0.079271;1.110009;2;41;0;41;100
neos-3695882-vesdre;37029;-145935.214286;38.466278;1;494;3;497;100
neos-3696678-lyvia;37029;5.599133;305.182559;2;46;0;46;100
neos-3699377-maori;37029;135877.224265;86.475608;2;111;0;111;100
neos-3703351-marne;37029;317056.210386;71.850613;2;57;0;57;100
neos-3740487-motru;37029;152.145486;225.379322;2;40549;75;40624;100
neos-3754480-nidda;37029;-1216923.270104;12.186832;1;3;0;3;100
neos-3755335-nizao;37029;50.030157;76.942384;2;566;1;567;100
neos-3759587-noosa;37029;48.334468;2.274444;2;331;1;332;100
neos-3761878-oglio;37029;422769.022545;74.732087;2;45;0;45;100
neos-3762025-ognon;37029;603955.746492;53.791954;2;38;0;38;100
neos-4165869-wannon;37029;282.410166;126.294292;3;477;5;482;100
neos-4260495-otere;37029;3336.109119;244.496957;2;831;14;845;100
neos-4264598-oueme;37029;4322420655.77198;2999.342361;241;4074;153;4227;100
neos-4285819-pedja;37029;9.198008;18.083988;2;128496;90;128586;100
neos-4290317-perth;37029;6352398.05574;0;2;615;1;616;100
neos-4292145-piako;37029;203285265.067233;3216.29981;241;3406;153;3559;100
neos-4295773-pissa;37029;0;3220.505376;1;5504;4;5508;100
neos-4300652-rahue;37029;0;52.333333;2;701;1;702;100
neos-4306827-ravan;37029;-35696.901913;771.837676;2;1131;13;1144;100
neos-4321076-ruwer;37029;1880.558333;39.333333;1;15314;1;15315;100
neos-4322846-ryton;37029;0.419848;25.388427;1;536;4;540;100
neos-4332801-seret;37029;222328.384492;5750.571985;4;135746;3528;139274;100
neos-4332810-sesia;37029;-33455.127882;4060.356957;11;117630;7991;125621;100
neos-4333464-siret;37029;24.731464;0.125;2;80;0;80;100
neos-4333596-skien;37029;-14653956.91493;0.180763;1;19;0;19;100
neos-4335793-snake;37029;0;300.868689;2;1075;2;1077;100
neos-4338804-snowy;37029;1447;0.3136;3;6;0;6;100
neos-4343293-stony;37029;51.62736;0.5;2;69;0;69;100
neos-4355351-swalm;37029;33.822611;0.094819;2;167;4;171;100
neos-4358725-tagus;37029;6199.400001;197.672071;73;709;15;724;100
neos-4359986-taipa;37029;0.296593;39.671142;1;1533;1;1534;100
neos-4360552-sangro;37029;-29.5;572.086779;1;10547;1;10548;100
neos-4387871-tavua;37029;36.445048;0.2;2;66;0;66;100
neos-4391920-timok;37029;9e-06;37.747142;1;7136;5;7141;100
neos-4393408-tinui;37029;340.267489;0.2;2;45;0;45;100
neos-4408804-prosna;37029;914.483516;66.321429;1;2892;1;2893;100
neos-4409277-trave;37029;0;347.723278;1;1908;1;1909;100
neos-4413714-turia;37029;43.474651;370.587709;1;1959;10;1969;100
neos-4532248-waihi;37029;0;26.808725;1;694;4;698;100
neos-4533806-waima;37029;3063.318841;99;1;1077;9;1086;100
neos-4545615-waita;37029;3606.59419;108.263827;1;15339;63;15402;100
neos-4555749-wards;37029;3026.812121;70;1;814;7;821;100
neos-4562542-watut;37029;3743.304348;85.428571;1;3136;14;3150;100
neos-4647027-thurso;37029;26911.641616;127.083433;1;2424;0;2424;100
neos-4647030-tutaki;37029;26911.641616;130.175014;1;2778;0;2778;100
neos-4647032-veleka;37029;26587.908699;174.815461;1;3834;0;3834;100
neos-4650160-yukon;37029;-22688.54768;228.864;1;5;0;5;100
neos-4722843-widden;37029;1841.255082;1452.768981;2;405;6;411;100
neos-4724674-aorere;37029;3758.753179;59.078997;3;508;10;518;100
neos-4736745-arroux;37029;653873224.676537;1.560199;2;43;0;43;100
neos-4738912-atrato;37029;617323325.173629;52.400465;2;46;0;46;100
neos-4754521-awarau;37029;0;0;1;1197;6;1203;0
neos-4760493-puerua;37029;1908.243695;237.071976;1;34530;3;34533;100
neos-476283;37029;406.244708;4.622056;2;4385;0;4385;100
neos-4763324-toguru;37029;1120.986062;232.945926;1;32610;2;32612;100
neos-4797081-pakoka;37029;0;821.218711;1;4799;2;4801;100
neos-4805882-barwon;37029;1603.90283;209.539059;1;234;1;235;100
neos-480878;37029;515.138796;1.008444;2;17;0;17;100
neos-4954274-beardy;37029;18659.208282;301.285291;2;877;2;879;100
neos-4954672-berkel;37029;3733961;4.007059;2;3;0;3;100
neos-4966258-blicks;37029;354.545455;449.137117;3;1446;4;1450;100
neos-4971100-bodrog;37029;0;0;2;76;0;76;100
neos-4972437-bojana;37029;355.557128;29.484099;2;8929;4;8933;100
neos-4972461-bolong;37029;465.045599;63.71069;2;5561;3;5564;100
neos-4976951-bunnoo;37029;375.694372;27.122883;2;5691;4;5695;100
neos-4984115-canche;37029;-10414620.716097;6.967648;1;17863;0;17863;100
neos-498623;37029;16;43.578586;1;148;1;149;100
neos-5013590-toitoi;37029;1064.447092;169;1;13921;1;13922;100
neos-5018451-chiese;37029;-149772385.216405;18.530618;1;62754;0;62754;100
neos-503737;37029;50;47.555718;1;28;0;28;100
neos-5041822-cockle;37029;5696053.417116;2.418448;3;2703;26;2729;100
neos-5044663-wairoa;37029;4653100;578.73613;1;23047;2;23049;100
neos-5045105-creuse;37029;19.06667;19.669391;1;74;0;74;100
neos-5049753-cuanza;37029;464;69.6;3;2445;5;2450;100
neos-5051588-culgoa;37029;128.75;32.57449;1;125;0;125;100
neos-5052403-cygnet;37029;216.7871;83.839163;9;37597;179;37776;100
neos-506422;37029;0;6.6;1;45;0;45;100
neos-506428;37029;145945;95.648936;1;530;2;532;100
neos-5075914-elvire;37029;277.341888;1.484053;2;47;0;47;100
neos-5076235-embley;37029;1930;0.115385;2;900;0;900;100
neos-5078479-escaut;37029;7280.474567;0.468278;2;45;0;45;100
neos-5079731-flyers;37029;2004;1.087912;2;810;0;810;100
neos-5083528-gimone;37029;0;20.875;1;245;3;248;100
neos-5093327-huahum;37029;3934;1.841667;2;839;0;839;100
neos-5100895-inster;37029;2084;3.582418;2;603;0;603;100
neos-5102383-irwell;37029;1740;2.483516;2;929;0;929;100
neos-5104907-jarama;37029;639.917149;47.86104;2;8923;5;8928;100
neos-5106984-jizera;37029;721;3.5;2;3751;6;3757;100
neos-5107597-kakapo;37029;0;0.59125;2;41;0;41;100
neos-5108386-kalang;37029;620.501637;53.159082;2;14435;8;14443;100
neos-5114902-kasavu;37029;518;141.333333;3;13253;15;13268;100
neos-5115478-kaveri;37029;0;0.529375;2;42;0;42;100
neos-5116085-kenana;37029;452;142;3;5605;10;5615;100
neos-5118834-korana;37029;569.216333;121.434394;2;9730;6;9736;100
neos-5118851-kowhai;37029;1134;5.86;2;5506;8;5514;100
neos-5123665-limmat;37029;652.42743;72.359737;2;17494;8;17502;100
neos-5125849-lopori;37029;0;51.956886;1;39;0;39;100
neos-5129192-manaia;37029;0;10;1;3950;12;3962;100
neos-5138690-middle;37029;605.364996;107.846299;2;16544;8;16552;100
neos-5140963-mincio;37029;8877;2.142857;1;1;0;1;100
neos-5149806-wieprz;37029;0.027694;5.467604;3;467;12;479;100
neos-5151569-mologa;37029;686023627.750363;27.702234;2;2366;4;2370;100
neos-5178119-nalagi;37029;8.569859;18.674756;2;75;1;76;100
neos-5182409-nasivi;37029;0;18.341185;1;9;0;9;100
neos-5188808-nattai;37029;0;10.715654;1;639;0;639;100
neos-5189128-totara;37029;330131.390743;21.863581;1;990;2;992;100
neos-5192052-neckar;37029;-11980000;0.333333;3;0;0;0;100
neos-5193246-nerang;37029;0;707.729862;1;994;1;995;100
neos-5195221-niemur;37029;0;722.524895;1;907;1;908;100
neos-5196530-nuhaka;37029;0;698.361784;1;719;1;720;100
neos-520729;37029;-1391291.666667;7.783333;1;529;1;530;100
neos-5221106-oparau;37029;0;51.816243;1;332;2;334;100
neos-5223573-tarwin;37029;0.1058;0.258185;1;15679;3;15682;100
neos-5251015-ogosta;37029;0.1058;0.226665;1;12047;2;12049;100
neos-525149;37029;60;12.153846;1;289;5;294;100
neos-5260764-orauea;37029;58748.022532;10.633838;1;63;0;63;100
neos-5261882-treska;37029;22721.328;7.770659;1;14;0;14;100
neos-5266653-tugela;37029;20969.906674;15.508215;1;141;1;142;100
neos-5273874-yomtsa;37029;0;0.2152;1;14112;2;14114;100
neos-555001;37029;910619.201473;185.329242;1;42;0;42;100
neos-555343;37029;1241512.54944;273.503416;1;39;0;39;100
neos-555424;37029;1196312.54944;237.883186;1;37;0;37;100
neos-555884;37029;1026121.836055;271.3209;1;42;0;42;100
neos-565672;37029;43884.639336;66.477422;3;16809;17;16826;100
neos-574665;37029;4948073.456141;10.746401;1;44;0;44;100
neos-578379;37029;0;134.076115;1;1168;0;1168;100
neos-585192;37029;-1999690.155301;98.986682;2;176;0;176;100
neos-585467;37029;-1999711.795869;82.239088;2;22;0;22;100
neos-595904;37029;61134.474995;16.114622;2;65;0;65;100
neos-619167;37029;1.481241;35.984608;1;124;0;124;100
neos-631517;37029;6494999.999936;64.357845;1;7;0;7;100
neos-631710;37029;515;243.082736;2;6219;18;6237;100
neos-633273;37029;4678552871.15256;377.739286;1;192;0;192;100
neos-662469;37029;184340.629649;94.654114;1;485;2;487;100
neos-686190;37029;5134.81383;17.515957;1;121;0;121;100
neos-691058;37029;234;83.756531;1;234;0;234;100
neos-693347;37029;234;78.950927;1;737;0;737;100
neos-738098;37029;-1099;222.818437;1;156;0;156;100
neos-777800;37029;-80;67.656924;1;51;0;51;100
neos-780889;37029;3421500;0;1;649;10;659;0
neos-787933;37029;300;0;2;244;33;277;100
neos-799711;37029;-11228065.153797;0.946665;1;1284;0;1284;100
neos-799716;37029;4932670.661692;0.575059;1;126;0;126;100
neos-807639;37029;492.688889;1.37037;2;10;0;10;100
neos-820879;37029;24874.267857;62.867619;1;101;0;101;100
neos-824661;37029;51;60.642857;2;286;2;288;100
neos-824695;37029;42;33.8;3;95;1;96;100
neos-826224;37029;130;70;3;211;3;214;100
neos-826650;37029;32;109.347222;2;44;0;44;100
neos-826694;37029;73;92.333333;3;86;2;88;100
neos-826812;37029;70.011;151.137255;3;102;1;103;100
neos-826841;37029;32.0082;110.679849;2;44;0;44;100
neos-827015;37029;2.098071;332.649497;1;1674;3;1677;100
neos-827175;37029;116.00152;83.555556;2;198;2;200;100
neos-829552;37029;2.098071;250.649497;1;1549;1;1550;100
neos-831188;37029;1.76772;215.733333;1;56;0;56;100
neos-847302;37029;0;51.325978;1;55;0;55;100
neos-848198;37029;168781;0;2;139;0;139;100
neos-848589;37029;0;0.075873;1;1522;1;1523;100
neos-849702;37029;0;88.550656;1;26;0;26;100
neos-850681;37029;2087;55.075614;1;167;0;167;100
neos-860300;37029;1666.068586;9;1;52;1;53;100
neos-872648;37029;52.674788;0;2;1316;9;1325;8.37
neos-873061;37029;152.429202;0;2;1303;7;1310;34.11
neos-876808;37029;10030.533833;259.649605;2;6616;12;6628;100
neos-885086;37029;-243;13.945733;2;189;0;189;100
neos-885524;37029;11771.55529;9.581376;2;163;7;170;100
neos-911880;37029;23.26;17.220292;1;2;0;2;100
neos-911970;37029;23.26;20.048919;1;2;0;2;100
neos-913984;37029;1000;37.312893;1;151;3;154;100
neos-914441;37029;5660364.28377;78.177859;1;1697;0;1697;100
neos-916792;37029;26.203596;16.256328;2;89;0;89;100
neos-932721;37029;513000;0;3;105;4;109;100
neos-932816;37029;513000;0;2;225;6;231;100
neos-933562;37029;0;237.810567;1;58;0;58;100
neos-933638;37029;444022;0;2;203;3;206;100
neos-933966;37029;450019;0;2;158;4;162;100
neos-934278;37029;446011;0;2;306;2;308;100
neos-935234;37029;422081;0;2;334;1;335;100
neos-935627;37029;23250;0;2;359;1;360;100
neos-935769;37029;23430;0;2;371;1;372;100
neos-937511;37029;53020;0;2;514;1;515;100
neos-937815;37029;53700;0;2;500;1;501;100
neos-941262;37029;52113;0;2;354;1;355;100
neos-941313;37029;9431.37037;215.962963;2;562;12;574;100
neos-942830;37029;12;68.088474;1;30;0;30;100
neos-948126;37029;51842;0;2;391;0;391;100
neos-948346;37029;-208.675026;5.578968;5;546;19;565;100
neos-950242;37029;2;94;2;127;1;128;100
neos-953928;37029;-99.806667;0;3;230;3;233;0.1
neos-954925;37029;-221.766667;0;5;1031;28;1059;6.73
neos-956971;37029;-230.74;2.884533;4;747;15;762;100
neos-957143;37029;-205.296379;49.220165;4;522;14;536;100
neos-957323;37029;-204.807274;25.065217;3;326;11;337;100
neos-957389;37029;1.5;37.849369;1;107;1;108;100
neos-960392;37029;-238;290.178312;1;242;2;244;100
neos-983171;37029;52602;0;2;408;1;409;100
neos-984165;37029;52002;0;2;414;1;415;100
neos13;37029;-126.178378;42.587671;3;210;0;210;100
neos15;37029;144796.909577;0;2;1;0;1;79.65
neos16;37029;429;14.5;2;3;0;3;100
neos17;37029;0.222688;0;2;6;0;6;48.46
neos18;37029;11;56.166667;3;72;0;72;100
neos2;37029;-4717.666848;6.724359;1;7;0;7;100
neos22;37029;413700;227;1;30;0;30;100
neos5;37029;17.25;0;2;1;0;1;15
neos6;37029;110.98976;27.902196;4;118;7;125;100
neos8;37029;-2885.143864;22.041691;3;792;5;797;100
neos808444;37029;0;213.399502;1;259;1;260;100
neos9;37029;780;44.25;1;316;0;316;100
net12;37029;47.514236;175.350347;3;875;0;875;100
netdiversion;37029;455.8;769.6;2;7666;11;7677;100
newdano;37029;11.724138;8.447296;1;3;0;3;100
nexp-150-20-1-5;37029;84;0;2;43;0;43;27.27
nexp-150-20-8-5;37029;600;0;2;82;1;83;100
nexp-50-20-1-1;37029;34;0;2;1;0;1;17.24
nexp-50-20-4-2;37029;120;0;2;2;0;2;69.01
nh97_potential;37029;1462;73.2;2;5;0;5;100
nh97_tension;37029;1438;81.583333;2;2;0;2;100
nj1;37029;0;607;1;569;1;570;100
nj2;37029;0;607;1;659;1;660;100
nj3;37029;0;607;1;68280;1;68281;100
nobel-eu-DBE;37029;7426411.5;1.365;2;101;0;101;100
noswot;37029;-9;0;2;0;0;0;78.05
ns1111636;37029;96.25;19.25;1;615;1;616;100
ns1116954;37029;0;155.073174;1;916;1;917;100
ns1208400;37029;0;93.553865;1;69;0;69;100
ns1430538;37029;73.621609;9.970024;1;572;0;572;100
ns1456591;37029;361.939022;19;1;121;1;122;100
ns1606230;37029;13.225;179.971152;1;1838;0;1838;100
ns1631475;37029;817.193748;716.662243;1;1259;1;1260;100
ns1663818;37029;1;9.141146;1;6073;89;6162;100
ns1679495;37029;3337055.001914;100.246101;2;49286;12;49298;100
ns1685374;37029;-51.800913;96.218654;1;53546;1;53547;100
ns1688347;37029;2;7.363183;1;59;0;59;100
ns1690781;37029;-1022.785697;17.664172;2;193;1;194;100
ns1696083;37029;2;12.504268;1;168;1;169;100
ns1758913;37029;-1501.183256;121.987025;1;9905;6;9911;100
ns1760995;37029;-1379.173237;142;1;21082;9;21091;100
ns1778858;37029;-22635740;227.465047;2;328;0;328;100
ns1828997;37029;0;75;2;1281;4;1285;100
ns1830653;37029;6153;56.373873;1;142;0;142;100
ns1849932;37029;546;5.42577;1;1087;6;1093;100
ns1853823;37029;1172000;1386;2;54755;25;54780;100
ns1854840;37029;1.432e+11;1139.47326;2;6687;15;6702;100
ns1856153;37029;0;248.911984;1;176;0;176;100
ns1904248;37029;0;854.146124;14;2535;33;2568;100
ns1905797;37029;11.75098;19.65;1;210;1;211;100
ns1905800;37029;6.4366;16.364665;1;45;0;45;100
ns1952667;37029;0;10.112982;1;220;1;221;100
ns2017839;37029;77026281754033.4;1.017799;2;7955;0;7955;100
ns2034125;37029;0;796.623735;2;1885;1;1886;100
ns2071214;37029;0;2.208125;1;89;0;89;100
ns2081729;37029;4.6;1.04;2;4;0;4;100
ns2122698;37029;62785.622771;194.641858;1;631;1;632;100
ns2124243;37029;53998.333333;195.416667;1;499;1;500;100
ns2137859;37029;24629;42.075016;1;793;7;800;100
ns4-pr3;37029;36073;12;1;139;0;139;100
ns4-pr6;37029;29145.75;8.875;1;45;0;45;100
ns4-pr9;37029;35175;9;1;88;0;88;100
ns894236;37029;18;199.499882;2;430;1;431;100
ns894244;37029;16;342.075798;2;1462;2;1464;100
ns894786;37029;14;210.864769;2;1566;2;1568;100
ns894788;37029;7;91.946694;2;152;0;152;100
ns903616;37029;22;385.201946;2;1120;2;1122;100
nsa;37029;91.44794;7.482504;1;8;0;8;100
nsr8k;37029;17500809.511815;639.929911;1;9403;3;9406;100
nsrand-ipx;37029;646400;0;2;68;2;70;100
nu120-pr12;37029;38070;13.695833;1;48;0;48;100
nu120-pr3;37029;21306.442308;42.751022;1;122;0;122;100
nu120-pr9;37029;19062.5;28.652083;1;81;0;81;100
nu25-pr12;37029;52757.5;11.9;1;51;0;51;100
nu4-pr9;37029;35175;21.713333;1;82;0;82;100
nu60-pr9;37029;22850;28.383333;1;87;0;87;100
nucorsav;37029;29.0461;81.214406;2;60027;268;60295;100
nursesched-medium-hint03;37029;33.468485;460.316255;1;1120;3;1123;100
nursesched-medium04;37029;398;286.520833;2;751;7;758;100
nursesched-sprint-hidden09;37029;580.911765;177.875;2;344;2;346;100
nursesched-sprint-late03;37029;34.254806;178.177416;1;403;1;404;100
nursesched-sprint02;37029;170.416667;127.291667;2;209;2;211;100
nw04;37029;16310.666667;2;1;253;7;260;100
ofi;37029;6131846109.62063;1781.999298;135;9301;140;9441;100
ofi2;37029;6124829152.73116;3158.688481;133;7174;188;7362;100
oocsp-racks030e6cci;37029;0;0;1;211;2;213;0
opm2-z10-s2;37029;-19912;0;4;23804;11;23815;41.13
opm2-z10-s4;37029;-17801;0;4;24767;10;24777;46.49
opm2-z11-s8;37029;-24040;0;4;51650;13;51663;44.72
opm2-z12-s14;37029;-39815;0;6;111586;26;111612;38.07
opm2-z12-s7;37029;-39769;0;5;104972;26;104998;39.3
opm2-z12-s8;37029;-34893;0;5;111237;26;111263;40.39
opm2-z6-s1;37029;-2356;0;3;319;1;320;62.01
opm2-z7-s2;37029;-7132;0;4;998;2;1000;30.62
opm2-z7-s8;37029;-6856;0;4;772;2;774;39.01
opm2-z8-s0;37029;-8004;0;3;3862;3;3865;49.26
opt1217;37029;-20.02139;8.22549;1;1;0;1;100
osorio-cta;37029;0;3.5e-05;1;59;0;59;100
p0201;37029;6875;20;1;2;0;2;100
p100x588b;37029;58977;0;2;2;0;2;23.18
p200x1188c;37029;15747;0;2;2;0;2;4.44
p2756;37029;2718;2.345553;2;6;0;6;100
p500x2988;37029;72594;0;2;27;0;27;1.06
p500x2988c;37029;17212;0;2;26;0;26;13.13
p500x2988d;37029;6;0;2;24;0;24;0
p6b;37029;-53;0;3;35;0;35;15.87
p80x400b;37029;45896;0;2;1;0;1;15.7
pb-fit2d;37029;-22372.476239;842.898884;1;7522;11;7533;100
pb-gfrd-pnc;37029;8316.011268;30.700616;1;121;1;122;100
pb-grow22;37029;-449681.200587;122.632175;1;448;1;449;100
pb-market-split8-70-4;37029;0;2.197219;1;0;0;0;100
pb-simp-nonunif;37029;6;513.5;2;3638;49;3687;100
peg-solitaire-a3;37029;1;289.311002;1;378;0;378;100
pg;37029;-11098.657382;17.215049;2;5;0;5;100
pg5_34;37029;-16012.248077;18.476238;2;6;0;6;100
physiciansched3-3;37029;2432694.766159;1308.126367;17;54267;113;54380;100
physiciansched3-4;37029;1124678.224456;1173.049171;9;35880;53;35933;100
physiciansched5-3;37029;5180;1133.735241;4;1374;3;1377;100
physiciansched6-1;37029;7500;799.143056;2;610;10;620;100
physiciansched6-2;37029;43012.5;744.696528;2;620;10;630;100
pigeon-08;37029;-8000;8.25974;1;2;0;2;100
pigeon-10;37029;-10000;13.559596;1;2;0;2;100
pigeon-11;37029;-11000;16.690909;1;3;0;3;100
pigeon-12;37029;-12000;21.818182;1;4;0;4;100
pigeon-13;37029;-13000;24;1;4;0;4;100
pigeon-16;37029;-16000;74.018182;1;6;0;6;100
pigeon-19;37029;-19000;59.036364;1;31;0;31;100
pigeon-20;37029;-20000;62.509091;1;33;0;33;100
piperout-03;37029;68814.99759;424.596014;17;368;6;374;100
piperout-08;37029;99128.924471;558.127794;17;317;7;324;100
piperout-27;37029;6970;1154.464464;12;527;6;533;100
piperout-d20;37029;25533.842105;676.796097;2;1038;2;1040;100
piperout-d27;37029;7083.116279;1022.542306;2;1399;2;1401;100
pk1;37029;0;2.791536;1;0;0;0;100
polygonpack3-15;37029;-96519350.40932;31.158333;3;1506;6;1512;100
polygonpack4-10;37029;-93676953.4701;20.073813;3;491;2;493;100
polygonpack4-15;37029;-114052801.79086;42.642788;3;1397;6;1403;100
polygonpack4-7;37029;-75324958.8742;9.351219;3;225;1;226;100
polygonpack5-15;37029;-42382234.50354;24.00431;3;1584;7;1591;100
pp08a;37029;15000;0;2;0;0;0;100
pp08aCUTS;37029;16630.402442;0;2;3;0;3;100
probportfolio;37029;5;15.184084;2;3;0;3;100
prod1;37029;-100;6.72495;2;1;0;1;100
prod2;37029;-100;4.433874;2;1;0;1;100
proteindesign121hz512p19;37029;3197.772133;67.38213;1;16914;120;17034;100
proteindesign121hz512p9;37029;1423.904449;61.920249;1;753;9;762;100
proteindesign121pgb11p9;37029;1173.710433;49.777201;1;632;8;640;100
proteindesign122trx11p8;37029;1720.461105;46.268597;1;557;7;564;100
protfold;37029;0;35;2;18;0;18;100
pw-myciel4;37029;0;51.865481;6;36;0;36;100
pythago7824;37029;0;580.777778;6;948;3;951;100
pythago7825;37029;0;586.777778;8;917;4;921;100
qap10;37029;332.566228;55;1;421;0;421;100
qiu;37029;1805.177143;0;2;5;0;5;100
qnet1;37029;98035.87;7.221868;2;19;0;19;100
qnet1_o;37029;96705.12;0;2;8;0;8;100
queens-30;37029;-30;0;3;214;2;216;25
r4l4-02-tree-bounds-50;37029;510876207;651.016667;2;49;0;49;100
r50x360;37029;2016;0;2;1;0;1;21.96
r80x800;37029;5520;0;2;1;0;1;3.53
radiationm18-12-05;37029;17554.5;196.264403;1;187;1;188;100
radiationm40-10-02;37029;155306.7;933.01825;1;1293;7;1300;100
rail01;37029;-92.0873;2555.841711;1;11871;5;11876;100
rail02;37029;-206.6102;3014.501667;1;132766;13;132779;100
rail03;37029;-920.273763;12441.976674;1;165017;36;165053;100
rail507;37029;216;0;3;662;12;674;24.14
railway_8_1_0;37029;397;59.076317;3;9;0;9;100
ramos3;37029;440;0;3;1543;1;1544;100
ran12x21;37029;4080;0;2;0;0;0;11.35
ran13x13;37029;3521;0;2;0;0;0;8.27
ran14x18-disj-8;37029;12451.012696;0;2;20;0;20;100
ran14x18;37029;4265;0;2;1;0;1;14.9
ran16x16;37029;4333;0;2;0;0;0;13.34
rd-rplusc-21;37029;100;4.122871;1;507;1;508;100
reblock115;37029;-39365983.337347;271.565472;1;193;0;193;100
reblock166;37029;-886882876.965829;382.279623;1;449;0;449;100
reblock354;37029;-39640995.765204;569.832903;3;801;2;803;100
reblock420;37029;-886535897.522137;986.979676;1;2268;0;2268;100
reblock67;37029;-39339910.923037;159.950504;1;59;0;59;100
rfds-4-days;37029;-1158940.978167;68.027009;1;73677;26;73703;100
rlp1;37029;13.244444;9.961905;1;1;0;1;100
rmatr100-p10;37029;360.593308;9.692735;1;212;0;212;100
rmatr100-p5;37029;762.040054;5;1;389;0;389;100
rmatr200-p10;37029;1550.620783;10;1;10438;0;10438;100
rmatr200-p20;37029;688.357943;19.982266;1;3401;0;3401;100
rmatr200-p5;37029;3283.653831;5;1;10833;0;10833;100
rmine10;37029;-1926.821009;886.351115;2;4089;1;4090;100
rmine11;37029;-2511.986814;1275.572328;14;11129;21;11150;100
rmine13;37029;-3504.619914;1108.274293;2;44735;5;44740;100
rmine14;37029;-4308.869811;2215.505904;7;91819;25;91844;100
rmine15;37029;-5041.420189;4256.942532;4;175411;20;175431;100
rmine6;37029;-436.021627;48.709031;12;140;1;141;100
rocI-3-11;37029;-111086.671772;567.73396;1;44;0;44;100
rocI-4-11;37029;-11111086.671772;800.875467;1;65;0;65;100
rocII-10-11;37029;-11.974865;290.286693;1;512;2;514;100
rocII-4-11;37029;-11.937162;82.5;1;133;0;133;100
rocII-5-11;37029;-11.94973;122.235744;1;185;1;186;100
rocII-7-11;37029;-11.964093;212.677972;1;312;1;313;100
rocII-8-11;37029;-11.968581;244.764303;1;393;1;394;100
rocII-9-11;37029;-11.972072;279.075237;1;461;2;463;100
rococoB10-011000;37029;8350.199468;49.840978;1;112;0;112;100
rococoC10-001000;37029;7515.271029;14.894221;1;53;0;53;100
rococoC11-010100;37029;8773.206543;49.89581;1;157;0;157;100
rococoC11-011100;37029;9024.205406;56.60339;1;121;0;121;100
rococoC12-010001;37029;26787.292147;50.829414;1;199;0;199;100
rococoC12-111000;37029;27337.357381;53.501346;1;235;0;235;100
roi2alpha3n4;37029;-80.526722;7.807845;2;696;9;705;100
roi5alpha10n8;37029;-87.787142;16;2;2042;26;2068;100
roll3000;37029;11097.127677;46.77651;3;34;0;34;100
rout;37029;981.864286;9.898077;1;1;0;1;100
rpp22falsei;37029;0;0;1;40;0;40;0
rvb-sub;37029;11.206514;4.571429;1;676;5;681;100
s100;37029;-0.171097;39.317795;1;24167;23;24190;100
s1234;37029;0.361925;1.578587;3;675;1;676;100
s250r10;37029;-0.165732;55.381636;2;10354;28;10382;100
s55;37029;-22.151773;0;1;1768;4;1772;0
s82;37029;-33.833613;482.284414;2;202793;141;202934;100
satellites1-25;37029;-20;68.01912;1;135;0;135;100
satellites2-25;37029;-30;356.7768;1;27610;2;27612;100
satellites2-40;37029;-30;133.152561;1;5048;2;5050;100
satellites2-60-fs;37029;-30;507.455315;1;2925;1;2926;100
satellites2-60;37029;-30;133.152561;1;4537;2;4539;100
satellites3-25;37029;-39;966.359942;1;230223;5;230228;100
satellites3-40-fs;37029;-39;942.263869;1;23813;4;23817;100
satellites3-40;37029;-39;963.231625;1;230464;5;230469;100
savsched1;37029;31271.151902;0;2;122613;39;122652;100
scpj4scip;37029;183;0;3;1240;20;1260;41.86
scpk4;37029;389;0;3;2490;24;2514;21.18
scpl4;37029;360;0;3;4759;53;4812;36.88
scpm1;37029;774;0;3;44959;146;45105;37.97
scpn2;37029;741;0;3;71719;282;72001;38.76
sct1;37029;-218.139003;91.32546;1;1486;0;1486;100
sct2;37029;-231.116964;14.501214;1;63;0;63;100
sct31;37029;-31.962662;30.054226;1;189;0;189;100
sct32;37029;-62.990833;53.144038;1;685;0;685;100
sct5;37029;-228.176552;35.395811;2;236;2;238;100
seqsolve1;37029;4379.032014;371.073706;19;4560;182;4742;100
seqsolve2short4288;37029;0;419.969766;4;3287;38;3325;100
seqsolve3short4288excess384;37029;-46401.234768;425.509375;7;13667;64;13731;100
set1ch;37029;110241.5;0;2;1;0;1;100
set3-09;37029;1263.077974;49.748593;3;40;0;40;100
set3-10;37029;788.890655;50.61299;3;38;0;38;100
set3-15;37029;8364.040745;53.876403;3;42;0;42;100
set3-16;37029;9916.808562;58.149187;3;38;0;38;100
set3-20;37029;10347.381087;53.849605;3;38;0;38;100
seymour-disj-10;37029;320.000002;2e-06;3;1724;1;1725;100
seymour;37029;454;0;3;199;0;199;7.33
seymour1;37029;422.819841;0;3;187;0;187;2.94
shiftreg1-4;37029;131.656032;300.178571;1;52;0;52;100
shiftreg2-7;37029;206.733052;286.044999;1;81;0;81;100
shiftreg5-1;37029;520.839888;630.584408;1;334;0;334;100
shipsched;37029;0;2.147365;5;131;2;133;100
shipschedule3shipsi;37029;-265650;0;1;37;0;37;0
shipschedule6shipsmixi;37029;-301650;0;1;56;0;56;0
shipschedule8shipsmixuci;37029;-401100;0;1;65;1;66;0
shs1014;37029;22137.410363;391.180556;1;176630;19;176649;100
shs1042;37029;9455.525826;684.883411;1;68144;23;68167;100
siena1;37029;10163179.229002;146.859338;1;1631;4;1635;100
sing11;37029;18640171.224643;331.879469;1;8026;8;8034;100
sing161;37029;19071259.113927;996.464534;1;62877;34;62911;100
sing17;37029;35483848.876514;554.751047;1;29361;21;29382;100
sing2;37029;17150914.71694;252.506822;1;1807;1;1808;100
sing245;37029;25024015.754083;519.079791;1;11963;9;11972;100
sing326;37029;7717674.801189;203.886687;1;2683;2;2685;100
sing359;37029;22534478.962498;1259.613224;1;83328;40;83368;100
sing44;37029;8102513.2194;177.330369;1;3293;3;3296;100
sing5;37029;18418516.013137;272.410096;1;3747;6;3753;100
snip10x10-35r1budget17;37029;30;2.340909;1;484;0;484;100
snp-02-004-104;37029;548044802.97509;10.217187;2;4316;0;4316;100
snp-04-052-052;37029;728196432.049806;735.582559;2;3914;2;3916;100
snp-06-004-052;37029;1787138156.58097;33.734354;2;6230;1;6231;100
snp-10-004-052;37029;5842625068.20526;48.106063;2;14178;1;14179;100
snp-10-052-052;37029;5842626434.04626;1694.316668;2;16709;5;16714;100
sorrell3;37029;-11;0;3;753;13;766;31.25
sorrell4;37029;-16;0;3;2814;30;2844;33.33
sorrell7;37029;-138;0;3;408;5;413;29.59
sorrell8;37029;-259;0;3;112;1;113;26
sp150x300d;37029;71;0;2;1;0;1;2.9
sp97ar;37029;807607302.399999;1.342794;4;557;9;566;100
sp97ic;37029;597287696.727546;1.277104;3;413;6;419;100
sp98ar;37029;642003743.188383;1.613817;16;716;37;753;100
sp98ic;37029;633805370.656431;1.781976;4;378;7;385;100
sp98ir;37029;265679354.122102;8.206982;4;68;1;69;100
splice1k1;37029;-1646.777979;8.512635;1;16827;8;16835;100
splice1k1i;37029;-1654;0;1;199;5;204;0
square23;37029;8.333333;12.444444;1;146;3;149;100
square31;37029;8.5;13.75;1;779;13;792;100
square37;37029;8.666667;15;1;2272;32;2304;100
square41;37029;8.839612;15.068891;1;3611;44;3655;100
square47;37029;8.755814;15.976744;1;5996;90;6086;100
stoch-vrpvrp-s5v2c8vrp-v2c8i;37029;0;107;1;30;0;30;100
stockholm;37029;175;0;2;460;0;460;40
stp3d;37029;604.886283;537.229946;2;25514;20;25534;100
sts405;37029;357;0;2;665;2;667;0
sts729;37029;665;0;2;3503;5;3508;0
supportcase1;37029;20078;0.020624;2;299;5;304;100
supportcase10;37029;3.383924;1850.997936;1;9733;3;9736;100
supportcase12;37029;-7609.533054;54.777672;1;1498;2;1500;100
supportcase14;37029;272;9.894737;1;2;0;2;100
supportcase16;37029;272;9;1;2;0;2;100
supportcase17;37029;0;88.508268;2;9;0;9;100
supportcase18;37029;87;9.141806;2;53;1;54;100
supportcase19;37029;12677206;370.390975;1;25880;62;25942;100
supportcase2;37029;0;7.75;1;9589;55;9644;100
supportcase20;37029;2442.144012;4.88286;1;19;0;19;100
supportcase23;37029;-12952;674.436182;1;1593;0;1593;100
supportcase25;37029;0.036932;11.225059;1;102;0;102;100
supportcase26;37029;1288.102161;0.009948;2;1;0;1;100
supportcase27i;37029;0;0.028235;1;1;0;1;100
supportcase3;37029;0;754.600046;3;211;1;212;100
supportcase30;37029;0;102.85702;1;64;0;64;100
supportcase31;37029;-1120655.076;0;3;1831;76;1907;69.88
supportcase33;37029;-450.933468;67.82818;2;593;2;595;100
supportcase34;37029;72.664116;339.350876;1;1223;3;1226;100
supportcase35;37029;77847.333333;96;2;116;0;116;100
supportcase37;37029;-5865.764096;28.04048;2;844;0;844;100
supportcase39;37029;-1062330.369524;22.808785;5;118;9;127;100
supportcase4;37029;0;537.153071;3;189;1;190;100
supportcase40;37029;22536.483379;19;1;254;0;254;100
supportcase41;37029;28;23.62447;5;281;1;282;100
supportcase42;37029;7.343539;48.081295;1;1561;2;1563;100
supportcase43;37029;0;48.147044;2;44858;3;44861;100
supportcase6;37029;45090.732163;30.239669;1;1522;7;1529;100
supportcase7;37029;-2396.218213;53.14731;2;1935;0;1935;100
swath;37029;334.496858;2.2;1;42;0;42;100
swath1;37029;334.496858;0.6;1;39;0;39;100
swath2;37029;334.496858;0.7;1;35;0;35;100
swath3;37029;334.496858;0.8;1;34;0;34;100
t1717;37029;134531.021428;79.098998;1;290;4;294;100
t1722;37029;98815.407611;52.399108;1;163;2;165;100
ta1-UUM;37029;3693674.556772;4.190418;1;4;0;4;100
ta2-UUE;37029;41427354.755773;0.680983;2;184;0;184;100
tanglegram1;37029;0;146;1;242;2;244;100
tanglegram2;37029;0;74;1;38;0;38;100
tanglegram4;37029;0;214;1;829;3;832;100
tanglegram6;37029;0;100;1;64;0;64;100
tbfp-bigm;37029;-178.153988;30;1;251;0;251;100
tbfp-network;37029;23.261535;31;1;917;3;920;100
Test3;37029;2669532.692462;22.368722;2;246;3;249;100
thor50dday;37029;204179;0;2;248;3;251;100
timtab1;37029;1234321.333333;18.45;2;1;0;1;100
timtab1CUTS;37029;613590.095426;35.885811;2;3;0;3;100
timtab2;37029;1487304.333333;29.783333;2;1;0;1;100
tokyometro;37029;11100;243.797433;2;66;0;66;100
toll-like;37029;0;339.5;1;40;0;40;100
tpl-tub-ss16;37029;8052373.477492;2148.906605;2;89555;192;89747;100
tpl-tub-ws1617;37029;10498468.058836;2262.455897;2;119887;281;120168;100
tr12-30;37029;188435.464884;3.580258;2;2;0;2;100
traininstance2;37029;0;641.688695;2;60;0;60;100
traininstance6;37029;0;381.122112;2;44;0;44;100
transportmoment;37029;-70929535815.38;783.890174;2;208;0;208;100
trento1;37029;5182758.848056;76.426737;1;586;0;586;100
triptim1;37029;22.868088;2111.393837;1;9179;3;9182;100
triptim2;37029;10.866359;800.023299;1;10087;3;10090;100
triptim3;37029;13.511741;803.795145;1;10045;3;10048;100
triptim4;37029;9.207022;602.920956;1;11465;3;11468;100
triptim7;37029;2336.732602;589.654105;2;12325;7;12332;100
triptim8;37029;2336.754853;582.63451;2;14188;6;14194;100
tw-myciel4;37029;3.838028;125.746479;6;180;1;181;100
uc-case11;37029;611267.013003;118.157436;1;2724;0;2724;100
uc-case3;37029;7181.264177;95.341586;1;1916;0;1916;100
uccase10;37029;38988.693469;403.985961;1;2713;1;2714;100
uccase12;37029;11507.285324;38.32;1;2060;0;2060;100
uccase7;37029;26527.789654;162.379998;1;3391;0;3391;100
uccase8;37029;11142.163196;63.982247;1;2777;0;2777;100
uccase9;37029;10819.582997;76.021209;1;4221;0;4221;100
uct-subprob;37029;242;56.400387;1;56;0;56;100
umts;37029;91618146.215272;77.667697;2;50;0;50;100
unitcal_7;37029;19387712.348556;143.515421;2;863;0;863;100
usAbbrv-8-25_70;37029;95;142.568932;3;38;0;38;100
usafa;37029;11.961749;2930.074494;2;49895;147;50042;100
v150d30-2hopcds;37029;52;0;3;101;1;102;26.83
van;37029;1.72352;5.404444;1;2422;0;2422;100
var-smallemery-m6j6;37029;-156.056268;90.190835;2;1400;7;1407;100
vpm2;37029;13.372866;5.698001;2;1;0;1;100
vpphard;37029;0;126.795208;1;221;3;224;100
vpphard2;37029;0;224.687229;1;647;10;657;100
wachplan;37029;-9;59.730159;1;37;0;37;100
wnq-n100-mw99-14;37029;194.184211;80.973684;3;4615;32;4647;100
xmas10-2;37029;-548.904684;180.189643;1;214;0;214;100
xmas10;37029;-449.063962;131.814139;7;200;0;200;100
z26;37029;-967;0;3;2732;43;2775;18.53
zeil;37029;813.510308;818.357568;2;85164;13;85177;100
zib54-UUE;37029;19164366;0;2;52;0;52;85.45
