Instance;Seed;Cost;Fractionality;Rounds;LPtime(ms);ZItime(ms);SumLPZI(ms)
10teams;0;917.000000;36.587901;1;56;0;56
22433;0;21552.708079;24.962328;5;6;0;6
23588;0;8342.863244;17.617619;4;4;0;4
2club200v15p5scn;0;-100.423077;39.038462;5;130;3;133
30n20b8;0;5530.000000;41.625765;2;124;0;124
30_70_45_05_100;0;67.000000;-0.000000;5;829;2;831
30_70_45_095_100;0;48.000000;-0.000000;5;772;3;775
30_70_45_095_98;0;384.000000;-0.000000;6;913;3;916
50v-10;0;1493601.476062;-0.000000;2;4;0;4
a1c1s1;0;20885.065088;0.498062;2;8;0;8
a2c1s1;0;21087.746318;-0.000000;2;8;0;8
ab51-40-100;0;-437558462.000004;11.050000;2;411;1;412
ab67-40-100;0;-11186253442.000000;0.000000;1;312;0;312
ab69-40-100;0;-11186281442.000000;0.000000;1;290;0;290
ab71-20-100;0;-2390446504.400002;12.500000;2;230;0;230
ab72-40-100;0;-11186620442.000000;0.000000;1;322;0;322
academictimetablebig;0;427.000000;1969.364079;2;36906;17;36923
academictimetablesmall;0;0.000000;292.436400;2;226;2;228
acc-tight2;0;0.000000;120.187623;1;26;0;26
acc-tight4;0;0.000000;120.929764;1;23;0;23
acc-tight5;0;0.000000;103.994633;1;198;0;198
acc-tight6;0;0.000000;101.648651;1;223;0;223
adult-max5features;0;10710.000597;0.023689;2;933;7;940
adult-regularized;0;7841.000000;0.000000;3;2060;9;2069
aflow30a;0;1402.717622;2.301497;3;1;0;1
aflow40b;0;1129.417647;2.760099;3;6;0;6
air03;0;338864.250000;11.375000;1;64;0;64
air04;0;55535.436388;51.829962;1;176;0;176
air05;0;25877.609268;45.880497;1;133;0;133
aligninq;0;2755.000000;40.921868;7;15;1;16
allcolor10;0;1802.284773;270.271003;3;104;1;105
allcolor58;0;7158.427015;1797.339216;3;828;9;837
amaze22012-03-15i;0;0.000000;60.779484;2;106;2;108
amaze22012-06-28i;0;0.000000;31.445788;2;34;0;34
amaze22012-07-04i;0;0.000000;42.838914;2;44;0;44
app1-1;0;-2.000000;1.945752;2;8;0;8
app1-2;0;-23.000000;1.399234;3;368;1;369
app2-1;0;19294.250000;0.000000;2;30;0;30
app2-2;0;212092.500000;0.000000;2;1;0;1
app3;0;5627412.287938;3.142492;1;10;0;10
arki001;0;7579621.830840;15.454670;1;34;0;34
assign1-10-4;0;353.992926;52.000000;1;37;0;37
assign1-5-8;0;183.362555;24.000000;1;2;0;2
atlanta-ip;0;81.321096;294.518627;2;5913;2;5915
atm20-100;0;2141734.684878;120.774021;2;65;0;65
australia-abs-cta;0;0.000000;41.456087;1;62;0;62
b-ball;0;-1.818182;4.818182;1;0;0;0
b1c1s1;0;69995.090000;-0.000000;2;7;0;7
b2c1s1;0;69710.660000;-0.000000;2;13;0;13
bab1;0;-228225.182825;27.775000;1;96;0;96
bab2;0;-333527.631000;251.166667;2;11171;17;11188
bab3;0;-570105.793583;410.027865;2;28301;46;28347
bab5;0;-106670.400850;101.900000;2;579;2;581
bab6;0;-247189.899525;444.182540;2;5641;12;5653
bc;0;13.915046;0.268421;2;97;0;97
bc1;0;4.550543;0.028778;2;86;0;86
beasleyC1;0;102.000000;0.000000;2;2;0;2
beasleyC2;0;232.000000;0.000000;2;3;0;3
beasleyC3;0;951.000000;-0.000000;2;4;0;4
beavma;0;395292.332242;3.472328;2;1;0;1
berlin;0;1951.000000;0.000000;2;29;0;29
berlin_5_8_0;0;52.000000;56.334191;3;2;0;2
bg512142;0;506799.440536;51.840309;3;30;0;30
biella1;0;3060037.430763;98.993456;1;251;0;251
bienst1;0;11.724138;4.390524;1;2;0;2
bienst2;0;11.724138;5.390524;1;2;0;2
binkar10_1;0;6637.188027;9.084811;1;7;0;7
blend2;0;7.489992;0.686573;2;0;0;0
bley_xl1;0;265.338492;317.245986;8;19617;27;19644
bley_xs1;0;47020884.968217;85.931545;3;73;0;73
bley_xs1noM;0;51435831.085758;85.192705;2;64;0;64
bley_xs2;0;30478761.025431;42.229522;12;12;1;13
blp-ar98;0;9174.508280;11.800505;21;97;29;126
blp-ic97;0;5423.588709;1.337703;12;84;7;91
blp-ic98;0;6879.499245;1.657910;4;127;5;132
blp-ir98;0;3350.173368;3.875758;3;44;1;45
bmocbd3;0;45423160382.724037;0.000000;2;18838;30;18868
bmoipr2;0;-46628940.711029;7.840017;1;83;0;83
bnatt350;0;0.000000;109.731023;17;113;2;115
bnatt400;0;0.000000;124.271041;12;112;1;113
bppc4-08;0;51.590000;10.603204;1;20;0;20
bppc6-02;0;108.340000;11.296538;1;140;0;140
bppc6-06;0;200.633333;13.595370;1;152;0;152
bppc8-02;0;486.500000;3.194588;1;1;0;1
bppc8-09;0;444.436047;4.775100;1;3;0;3
brasil;0;32311.000000;0.000000;2;34;0;34
brazil3;0;2.000000;303.450558;1;234;0;234
breastcancer-regularized;0;105.150036;0.002191;2;9;0;9
bts4-cta;0;33524.637606;1130.000000;1;524;0;524
buildingenergy;0;33246.215059;1468.850000;2;17001;4;17005
cap6000;0;-2446875.000000;0.000000;3;38;0;38
cbs-cta;0;0.000000;29.948722;1;126;0;126
cdc7-4-3-2;0;-231.000000;-0.000000;3;38501;5;38506
chromaticindex1024-7;0;4.000000;16002.682953;2;2346;10;2356
chromaticindex128-5;0;4.000000;2021.163699;2;139;1;140
chromaticindex256-8;0;4.000000;4069.477083;2;388;2;390
chromaticindex32-8;0;4.000000;504.887500;2;17;0;17
chromaticindex512-7;0;4.000000;8183.527137;2;1103;4;1107
ci-s4;0;17.644894;41.309507;2;11;0;11
circ10-3;0;140.000000;209.309855;1;2088;1;2089
cmflsp40-24-10-7;0;52605868.952858;70.700930;3;353;0;353
cmflsp40-36-2-10;0;72898024.959478;295.649246;3;778;0;778
cmflsp50-24-10-4;0;64492612.641644;81.236085;3;329;0;329
cmflsp50-24-8-8;0;59814378.749021;131.869460;3;337;0;337
cmflsp60-36-2-6;0;97887903.946142;370.689759;3;1902;0;1902
CMS750_4;0;250.000000;227.976728;3;64;1;65
co-100;0;1246685.546783;10.401691;2;354;7;361
cod105;0;-8.000000;0.000000;3;490;1;491
comp07-2idx;0;0.000000;114.416667;2;1900;1;1901
comp08-2idx;0;0.000000;164.617047;3;175;1;176
comp12-2idx;0;3.000000;261.572878;1;1218;0;1218
comp16-3idx;0;4.000000;719.325252;1;7279;2;7281
comp21-2idx;0;0.000000;282.023529;3;487;1;488
control30-3-2-3;0;-20763026.787568;27.970540;1;4;0;4
core2536-691;0;783.000000;-0.000000;3;775;2;777
core2586-950;0;1169.000000;0.000000;3;546;1;547
core4284-1064;0;1272.000000;0.000000;3;2939;4;2943
core4872-1529;0;1851.000000;-0.000000;3;1705;3;1708
cost266-UUE;0;42001606.280000;-0.000000;2;65;0;65
cov1075;0;35.000000;0.000000;2;6;0;6
cryptanalysiskb128n5obj16;0;0.000000;5004.982410;128;1026;308;1334
csched007;0;269.251587;22.185714;1;33;0;33
csched008;0;171.000000;19.317572;1;9;0;9
csched010;0;332.422727;19.898990;1;33;0;33
cvrpa-n64k9vrpi;0;0.000000;157.478224;2;436;6;442
cvrpb-n45k5vrpi;0;0.000000;112.631845;2;240;2;242
cvrpp-n16k8vrpi;0;0.000000;39.002948;1;37;0;37
cvrpsimple2i;0;0.000000;19.221758;2;2;0;2
cvs08r139-94;0;-16.000000;66.000000;3;15;0;15
cvs16r106-72;0;-2.000000;71.000000;2;33;0;33
cvs16r128-89;0;-2.000000;88.000000;2;37;0;37
cvs16r70-62;0;-0.000000;62.000000;2;29;0;29
cvs16r89-60;0;-0.000000;60.000000;2;30;0;30
d10200;0;12425.583005;32.097057;1;40;0;40
d20200;0;12229.625788;62.339279;1;299;0;299
dale-cta;0;0.000000;0.004722;1;246;0;246
dano3mip;0;576.231620;15.297311;1;2042;0;2042
dano3_3;0;576.231620;1.932181;1;2078;0;2078
dano3_5;0;576.231620;2.871834;1;2151;0;2151
danoint;0;62.637280;5.819184;1;18;0;18
dc1c;0;1754946.863638;140.030585;1;291;0;291
dc1l;0;211357921.003601;0.000000;3;854;15;869
dcmulti;0;184917.234283;12.662065;3;2;0;2
decomp1;0;-120.000000;141.777778;1;41;0;41
decomp2;0;-160.000000;141.944444;1;40;0;40
dfn-bwin-DBE;0;797567.400000;0.000000;2;28;0;28
dfn-gwin-UUM;0;27467.257235;5.653537;1;1;0;1
dg012142;0;7485691.825683;37.560751;5;113;0;113
diameterc-mstc-v20a190d5i;0;291.000000;259.843574;3;83;0;83
diameterc-msts-v40a100d5i;0;324.000000;323.866618;3;64;1;65
disctom;0;-5000.000000;51.166667;1;194;0;194
disktom;0;-5000.000000;51.166667;1;183;0;183
dolom1;0;6556066.068315;111.218954;1;460;1;461
drayage-100-12;0;91134.076080;36.725496;1;48;0;48
drayage-100-23;0;103333.874073;41.554651;1;45;0;45
drayage-25-23;0;99718.790531;43.797371;1;44;0;44
drayage-25-27;0;95207.144904;44.816549;1;45;0;45
drayage-25-32;0;88256.306534;46.545775;1;56;0;56
ds-big;0;86.820068;30.669231;1;7256;21;7277
ds;0;57.234565;33.463549;1;1057;7;1064
dws008-01;0;2954.537147;2.158177;2;48;0;48
dws008-03;0;3277.007696;7.647345;2;134;1;135
dws012-01;0;5179.177491;3.971756;2;93;1;94
dws012-02;0;4796.532110;20.386873;3;232;4;236
dws012-03;0;4894.656489;18.648543;3;374;5;379
eil33-2;0;811.278996;3.615630;1;34;0;34
eilA101-2;0;803.373888;7.408683;1;889;7;896
eilB101;0;1075.247691;12.807028;1;20;0;20
eilC76-2;0;725.754458;7.780208;1;285;2;287
ej;0;1.000000;0.243844;1;0;0;0
elitserienhandball11i;0;0.000000;866.305983;2;435;1;436
elitserienhandball13i;0;0.000000;853.141952;2;417;1;418
elitserienhandball14i;0;0.000000;883.858328;2;372;1;373
elitserienhandball3i;0;0.000000;887.935483;2;375;1;376
enlight13;0;1.000000;1.000000;1;0;0;0
enlight15;0;1.000000;1.000000;1;0;0;0
enlight8;0;1.000000;1.000000;1;0;0;0
enlight_hard;0;15.500000;17.000000;1;0;0;0
eva1aprime5x5opt;0;-497.155823;0.512833;1;299;0;299
eva1aprime6x6opt;0;-495.398833;1.465785;1;1241;0;1241
ex10;0;100.000000;98.000000;1;17189;5;17194
ex1010-pi;0;314.000000;0.000000;3;479;2;481
ex9;0;81.000000;75.601201;1;1820;2;1822
exp-1-500-5-5;0;97666.305541;4.045842;2;2;0;2
f2000;0;1383.000000;1280.000000;2;3471;0;3471
f2gap201600;0;76429.862296;1.402159;1;3;0;3
f2gap401600;0;82274.237434;1.190020;1;3;0;3
f2gap40400;0;20650.898154;3.253580;1;1;0;1
f2gap801600;0;86570.120867;5.266841;1;4;0;4
fast0507;0;205.000000;-0.000000;3;209;3;212
fastxgemm-n2r6s0t2;0;27.000000;9.000000;1;30;0;30
fastxgemm-n2r7s4t1;0;27.000000;9.000000;1;34;0;34
fastxgemm-n3r21s3t6;0;84.000000;27.000000;1;2389;0;2389
fastxgemm-n3r22s4t6;0;84.000000;27.000000;1;2682;0;2682
fastxgemm-n3r23s5t6;0;84.000000;27.000000;1;2627;0;2627
fhnw-binpack4-48;0;0.000000;333.285714;2;127;0;127
fhnw-binpack4-58;0;0.000000;467.321429;2;133;0;133
fhnw-binpack4-77;0;0.000000;207.310714;2;106;0;106
fhnw-binschedule0;0;15642.000000;1053.297818;2;19089;29;19118
fhnw-binschedule2;0;2273.000000;211.693788;3;497;4;501
fhnw-schedule-paira100;0;-36.643681;5.149215;2;134;1;135
fhnw-schedule-paira200;0;-73.826479;8.940825;2;241;3;244
fhnw-schedule-paira400;0;-146.941079;19.266221;2;1125;12;1137
fhnw-schedule-pairb200;0;-58.887041;815.939903;3;2025;3;2028
fhnw-schedule-pairb400;0;-109.169750;2783.836162;3;12921;14;12935
fhnw-sq2;0;0.000000;14.223792;1;4;0;4
fiball;0;137.069168;86.665577;1;109;1;110
fiber;0;897538.360000;12.574421;2;3;0;3
fillomino7x7-0i;0;0.000000;330.286888;2;65;0;65
fixnet6;0;4536.000000;0.000000;2;1;0;1
fjspeasy01i;0;216.000000;1.364719;2;60;0;60
flugpl;0;1167875.166377;2.785325;1;0;0;0
g200x740;0;45614.000000;-0.000000;2;3;0;3
g200x740i;0;44069.000000;-0.000000;2;3;0;3
gasprod1-1;0;9698.001669;26.648753;6;453;1;454
gasprod1-2;0;12418.693782;43.662702;18;300;3;303
gasprod1-3;0;13830.718570;40.837432;64;298;11;309
gasprod2-1;0;1510393.402354;44.156867;6;1070;2;1072
gasprod2-2;0;1355909.537507;297.110788;36;1582;13;1595
gen-ip002;0;-511.036897;0.000000;3;0;0;0
gen-ip016;0;-9505.628173;1.906914;1;0;0;0
gen-ip021;0;6642.052620;2.217259;4;0;0;0
gen-ip036;0;-2162.833562;0.000000;3;0;0;0
gen-ip054;0;7350.684932;1.502477;8;0;0;0
gen;0;112555.106141;0.427450;2;1;0;1
genus-g31-8;0;-27.000000;114.000000;1;1096;1;1097
genus-g61-25;0;-58.000000;241.704715;1;546;2;548
genus-sym-g31-8;0;-27.000000;147.317165;2;3076;4;3080
genus-sym-g62-2;0;-54.000000;236.618889;1;24486;1;24487
genus-sym-grafo5708-48;0;-27.000000;159.026027;2;1563;0;1563
ger50-17-ptp-pop-3t;0;3466.323207;45.213645;1;100;0;100
ger50-17-ptp-pop-6t;0;6804.447088;50.477969;1;98;0;98
ger50-17-trans-dfn-3t;0;3453.475245;37.741927;1;187;1;188
ger50-17-trans-pop-3t;0;3456.252922;49.487013;1;186;2;188
ger50_17_trans;0;6850.628623;48.226110;1;160;1;161
germanrr;0;47650759.157540;58.297944;3;811;3;814
germany50-DBM;0;438028.000000;21.150000;1;148;0;148
germany50-UUM;0;597932.500000;26.450000;1;42;0;42
gesa2-o;0;25748173.191117;13.380406;2;4;0;4
gesa2;0;25502855.039680;8.989886;1;6;0;6
gfd-schedulen180f7d50m30k18-16i;0;22.033333;4323.065856;3;9603;162;9765
gfd-schedulen180f7d50m30k18;0;1.000000;6089.615745;5;5055;33;5088
gfd-schedulen25f5d20m10k3i;0;3.000000;26.483490;2;78;0;78
gfd-schedulen55f2d50m30k3i;0;4.000000;199.835377;2;218;3;221
ghoulomb4-9-10i;0;9.000000;9.160150;2;58;1;59
glass-sc;0;23.000000;0.000000;3;124;1;125
glass4;0;800002400.000000;8.568254;1;1;0;1
gmu-35-40;0;-2406943.556343;2.300342;1;4;0;4
gmu-35-50;0;-2608070.315743;3.444186;1;7;0;7
gmut-75-50;0;-14182312.661731;4.988967;1;494;4;498
gmut-76-40;0;-14171086.316075;9.054451;1;289;1;290
gmut-76-50;0;-14173884.188063;4.201959;1;294;3;297
gmut-77-40;0;-14173396.636852;2.973250;1;358;1;359
go19;0;96.000000;-0.000000;3;4;0;4
gr4x6;0;229.050000;-0.000000;2;0;0;0
graph20-20-1rand;0;-37.000000;43.000000;1;46;0;46
graph20-80-1rand;0;-110.000000;120.050000;2;1398;2;1400
graph40-20-1rand;0;-157.000000;171.500000;1;4129;2;4131
graph40-40-1rand;0;-300.000000;326.969290;1;91634;10;91644
graphdraw-domain;0;12672.000000;18.742857;1;2;0;2
graphdraw-gemcutter;0;4310.000000;12.048387;2;1;0;1
graphdraw-grafo2;0;35762.000000;342.865217;1;830;3;833
graphdraw-mainerd;0;30496.000000;117.161290;1;80;0;80
graphdraw-opmanager;0;54717.000000;236.310976;1;382;1;383
gsvm2rl11;0;35640.343493;0.000000;2;369;0;369
gsvm2rl12;0;50.000000;-0.000000;2;738;0;738
gsvm2rl3;0;0.600000;-0.000000;2;4;0;4
gsvm2rl5;0;10.000000;-0.000000;2;9;0;9
gsvm2rl9;0;16356.825869;0.000000;2;60;0;60
gt2;0;21166.000000;4.130952;2;0;0;0
h50x2450;0;11147.731511;3.696751;1;27;0;27
h80x6320;0;3700.000000;0.000000;1;26;0;26
h80x6320d;0;5325.160104;2.515625;1;38;0;38
hanoi5;0;1931.000000;245.237539;25;318;4;322
haprp;0;3679667.254486;41.766595;2;5;0;5
harp2;0;-74325169.345138;5.496152;1;3;0;3
hgms-det;0;-53793.320679;37.099950;1;184;0;184
hgms30;0;-53327.995245;51.804834;1;7653;0;7653
hgms62;0;-53394.446147;54.735370;1;14237;0;14237
hypothyroid-k1;0;-2846.896104;38.365286;3;7204;7;7211
ic97_potential;0;4058.000000;55.450000;2;4;0;4
ic97_tension;0;3993.000000;15.366667;2;2;0;2
icir97_potential;0;6585.000000;169.917232;2;40;0;40
icir97_tension;0;6323.000000;102.600000;2;3;0;3
iis-100-0-cov;0;41.000000;0.000000;3;93;0;93
iis-bupa-cov;0;49.000000;-0.000000;3;169;0;169
iis-glass-cov;0;28.000000;0.000000;3;108;2;110
iis-hc-cov;0;22.000000;0.000000;3;153;2;155
iis-pima-cov;0;41.000000;-0.000000;3;208;1;209
irp;0;12123.530222;6.000000;1;74;1;75
istanbul-no-cutoff;0;62.541409;3.968407;1;254;0;254
ivu06-big;0;135.427718;95.799872;1;53133;157;53290
ivu06;0;135.901353;96.981489;1;14310;54;14364
ivu52;0;480.250439;82.514521;1;6195;14;6209
ivu59;0;884.456993;122.994949;1;208908;233;209141
janos-us-DDM;0;1488134.750000;22.375000;1;7;0;7
k16x240;0;11359.000000;0.000000;2;0;0;0
k16x240b;0;12874.000000;0.000000;2;0;0;0
k1mushroom;0;-3747.840298;42.576586;3;20523;23;20546
k1mushroomi;0;-4165.061224;64.102041;1;16203;3;16206
khb05250;0;126785464.000000;0.000000;2;1;0;1
l2p12;0;2.000000;842.371092;3;211;2;213
l2p1i;0;1.000000;607.693224;2;924;23;947
l2p2i;0;1.000000;837.619694;2;127;1;128
lectsched-1-obj;0;36.000000;28.046924;4;245;3;248
lectsched-1;0;0.000000;6.882322;2;194;4;198
lectsched-2;0;0.000000;20.773169;4;112;2;114
lectsched-3;0;0.000000;4.358796;9;200;6;206
lectsched-4-obj;0;3.000000;11.616600;4;54;1;55
lectsched-5-obj;0;15.000000;51.920712;3;162;2;164
leo1;0;530605779.573215;2.950107;3;75;2;77
leo2;0;572818097.713015;1.549961;3;109;3;112
liu;0;346.000000;11.204653;2;6;0;6
loopha13;0;6.279000;1.132999;2;176;0;176
lotsize;0;1335747.052789;7.405615;2;7;0;7
lr1dr02vc05v8a-t360;0;120707.344638;169.266715;1;1072;1;1073
lr1dr04vc05v17a-t360;0;247150.518188;322.854834;1;1975;1;1976
lr1dr12vc10v70b-t360;0;983958.597196;1051.434951;1;48013;9;48022
lr2-22dr3-333vc4v17a-t60;0;-72770.836006;244.127587;2;38571;8;38579
lrn;0;44373752.713965;53.546052;2;387;0;387
m100n500k4r1;0;-18.000000;0.000000;3;7;0;7
macrophage;0;35.000000;209.000000;1;5;0;5
mad;0;0.000000;3.404256;1;1;0;1
manna81;0;-11868.000000;0.000000;3;55;0;55
map06;0;-406.181173;7.868443;1;974;0;974
map10;0;-602.176181;11.248146;1;1025;0;1025
map14;0;-778.549324;11.962355;1;930;0;930
map14860-20;0;-998.836419;10.400693;1;1260;0;1260
map16715-04;0;-296.267898;4.997036;1;997;0;997
map18;0;-932.782685;11.173489;1;1343;0;1343
map20;0;-998.836419;10.400693;1;1289;0;1289
mappingmesh3x3mpeg2i;0;10000.000000;151.684473;2;20;0;20
mario-t-hard5i;0;-4482.000000;162.376472;1;130;1;131
markshare1;0;230.000000;-0.000000;2;0;0;0
markshare2;0;454.000000;0.000000;2;0;0;0
markshare_4_0;0;226.000000;0.000000;2;0;0;0
markshare_5_0;0;337.000000;0.000000;2;0;0;0
mas74;0;10482.795280;3.103514;1;0;0;0
mas76;0;38893.903641;2.555097;1;0;0;0
maxgasflow;0;-53620694.316699;233.514091;2;62;0;62
mc11;0;13520.000000;-0.000000;2;29;0;29
mc7;0;5797.000000;-0.000000;2;30;0;30
mc8;0;1944.000000;-0.000000;2;34;0;34
mcsched;0;474351.816438;29.021488;2;171;0;171
methanosarcina;0;0.000000;282.500000;1;60;0;60
mik-250-1-100-1;0;-0.000000;0.000000;2;2;0;2
mik-250-20-75-1;0;0.000000;0.000000;2;2;0;2
mik-250-20-75-2;0;-0.000000;-0.000000;2;2;0;2
mik-250-20-75-3;0;-0.000000;-0.000000;2;2;0;2
mik-250-20-75-4;0;-0.000000;-0.000000;2;2;0;2
mik-250-20-75-5;0;0.000000;-0.000000;2;2;0;2
milo-v12-6-r1-58-1;0;422507.582835;144.971323;2;147;0;147
milo-v12-6-r1-75-1;0;684446.509887;174.270141;2;211;0;211
milo-v12-6-r2-40-1;0;213638.744473;104.472692;2;82;0;82
milo-v13-4-3d-3-0;0;23373.122645;0.739975;1;16;0;16
milo-v13-4-3d-4-0;0;34049.245605;1.277727;1;29;0;29
mine-166-5;0;-552883467.060796;36.684884;5;127;0;127
mine-90-10;0;-827656854.061004;55.076435;1;92;0;92
mining;0;-885911894.603839;8594.317279;65;74891;1280;76171
minutedispatchstrategy;0;3582.138213;101.664381;1441;1977;589;2566
misc07;0;1415.000000;8.000000;1;2;0;2
mitre;0;114908.998992;168.716846;1;58;0;58
mkc;0;-339.570000;0.000000;3;31;0;31
mkc1;0;-579.270000;9.223228;3;37;0;37
mod010;0;6532.083333;15.166667;1;13;0;13
modglob;0;20786787.016883;-0.000000;2;1;0;1
moj-mining;0;-1520532907.350178;566.626558;2;49588;0;49588
momentum1;0;121860.460323;47.487111;2;133;0;133
momentum2;0;12884.172158;84.534262;3;548;2;550
mrcpspj30-15-5i;0;23.000000;129.522072;2;89;0;89
mrcpspj30-17-10i;0;25.000000;199.118709;38;138;12;150
mrcpspj30-53-3i;0;30.000000;45.671032;2;53;0;53
msc98-ip;0;19530897.712301;359.712140;2;1094;1;1095
mspp16;0;341.000000;3.000000;1;25025;152;25177
mspsphard01i;0;69.000000;43.936229;3;68;1;69
mspsphard03i;0;73.000000;88.703474;3;102;1;103
mtest4ma;0;60342.000000;0.000000;2;2;0;2
mushroom-best;0;0.079076;0.007000;3;244;3;247
mzzv11;0;-22076.000000;186.202623;2;249;1;250
mzzv42z;0;-20490.000000;179.192264;2;276;1;277
n13-3;0;4810470.000000;0.000000;2;3;0;3
n15-3;0;71710891.000000;0.000000;2;4985;0;4985
n2seq36f;0;71600.000000;-0.000000;3;34;1;35
n2seq36q;0;78631.821523;37.583580;3;157;3;160
n3-3;0;23704230.000000;0.000000;2;130;0;130
n3700;0;1342560.000000;0.000000;2;28;0;28
n3705;0;1342540.000000;0.000000;2;25;0;25
n3707;0;1301218.000000;0.000000;2;26;0;26
n3709;0;1324904.000000;-0.000000;2;26;0;26
n370a;0;1353042.000000;-0.000000;2;26;0;26
n370b;0;1373791.000000;-0.000000;2;27;0;27
n3div36;0;314000.000000;6.227888;3;124;3;127
n3seq24;0;198664.580534;43.960251;3;2219;38;2257
n4-3;0;12003175.000000;-0.000000;2;67;0;67
n5-3;0;10502425.000000;-0.000000;2;22;0;22
n6-3;0;10807500.000000;0.000000;2;44;0;44
n7-3;0;8409710.000000;0.000000;2;36;0;36
n9-3;0;20705025.000000;-0.000000;2;146;0;146
nag;0;465.000000;13.519045;3;44;0;44
neos-1061020;0;-145860.370608;501.435811;1;907;0;907
neos-1067731;0;669053.000000;87.000000;1;549;0;549
neos-1109824;0;278.000000;22.000000;1;33;0;33
neos-1112782;0;22000000110147.347656;0.000000;2;24;0;24
neos-1112787;0;19500000125389.667969;0.000000;2;21;0;21
neos-1122047;0;162.000000;0.000000;2;107;0;107
neos-1171448;0;-309.000000;5.777778;2;110;0;110
neos-1171692;0;-273.000000;4.936782;2;64;0;64
neos-1171737;0;-195.000000;9.875000;2;50;0;50
neos-1225589;0;5000000000.000000;-0.000000;2;1;0;1
neos-1311124;0;-182.000000;5.250000;2;3;0;3
neos-1324574;0;36.000000;135.000000;2;32;0;32
neos-1330346;0;35.000000;92.237431;2;65;0;65
neos-1337307;0;-201272.000000;272.493985;2;51;0;51
neos-1354092;0;46.000000;235.398385;2;1016;2;1018
neos-1367061;0;31320456.264497;6.250000;2;1328;1;1329
neos-1396125;0;3000.046554;10.228463;2;6;0;6
neos-1420546;0;22124.400000;103.140678;1;373;0;373
neos-1420790;0;2942.750002;75.132359;1;45;0;45
neos-1423785;0;-1773.639422;144.183541;2;366;0;366
neos-1425699;0;3175561447.505317;0.344988;1;0;0;0
neos-1426635;0;-178.000000;6.235119;2;2;0;2
neos-1426662;0;-52.000000;24.768519;2;3;0;3
neos-1429212;0;2425.386455;328.355033;1;4392;9;4401
neos-1430701;0;-78.000000;5.278895;2;2;0;2
neos-1436709;0;-129.000000;5.000000;2;3;0;3
neos-1440225;0;36.000000;35.209861;1;69;0;69
neos-1440460;0;-180.000000;5.527778;2;2;0;2
neos-1442119;0;-182.000000;7.291667;2;3;0;3
neos-1442657;0;-156.000000;6.083333;2;2;0;2
neos-1445532;0;-14382.000000;4.666667;2;27;0;27
neos-1445738;0;-18525.765543;192.856918;1;1123;0;1123
neos-1445743;0;-18902.810023;198.050465;1;980;0;980
neos-1445765;0;-18811.492536;210.050240;1;1174;0;1174
neos-1456979;0;154.000000;27.901173;1;38;0;38
neos-1516309;0;34769.833333;9.166667;2;27;0;27
neos-1582420;0;88.469527;56.693409;5;43;0;43
neos-1593097;0;19581.000000;35.532718;1;38;0;38
neos-1599274;0;31644.742857;8.000000;2;29;0;29
neos-1601936;0;1.000000;156.424985;1;692;0;692
neos-1603965;0;619257281.729079;159.275211;3;2078;1;2079
neos-1605061;0;6.150735;155.725970;1;1866;0;1866
neos-1605075;0;3.214461;180.849737;1;1900;0;1900
neos-1616732;0;174.000000;-0.000000;3;53;0;53
neos-1620770;0;22.000000;35.000000;2;185;0;185
neos-2294525-abba;0;251.550909;3.989993;1;89;0;89
neos-2328163-agri;0;27254.625000;57.595721;1;158;0;158
neos-2624317-amur;0;0.000000;20.419135;1;3;0;3
neos-2629914-sudost;0;39622.000000;15.000000;1;193;0;193
neos-2652786-brda;0;0.000000;17.502239;3;1;0;1
neos-2657525-crna;0;0.000000;22.230800;2;1;0;1
neos-2669500-cust;0;2221.900000;100.250838;1;472;5;477
neos-2746589-doon;0;1985.939796;54.551734;1;214;2;216
neos-2974461-ibar;0;472952396.770997;3364.000000;2;179972;31;180003
neos-2978193-inde;0;-2.418518;7.400000;1;61;0;61
neos-2978205-isar;0;-12.415307;30.200000;1;218;0;218
neos-2987202-jeir;0;-1847551552.236609;1035.632796;2;66976;1;66977
neos-2987310-joes;0;-610797465.676974;19.875000;1;979;0;979
neos-2991472-kalu;0;138.000000;18.269589;2;3191;102;3293
neos-3004026-krka;0;0.000000;832.000000;1;47;0;47
neos-3009394-lami;0;0.642857;216.628571;1;3;0;3
neos-3024952-loue;0;25442.000000;116.550000;5;218;0;218
neos-3025225-shelon;0;0.077135;318.031391;1;87669;20;87689
neos-3046601-motu;0;185.000000;0.023300;2;0;0;0
neos-3046615-murg;0;192.000000;0.024900;2;0;0;0
neos-3048764-nadi;0;-3883988306.366695;0.000000;1;37;0;37
neos-3065804-namu;0;0.000000;0.000000;1;231;0;231
neos-3068746-nene;0;77427529.530929;51.698455;2;146;0;146
neos-3072252-nete;0;10593526.000000;1.938794;2;1;0;1
neos-3075395-nile;0;1127152.765198;9.064729;1;72;0;72
neos-3083784-nive;0;0.000000;0.404553;1;7;0;7
neos-3083819-nubu;0;6290575.552807;5.598385;1;37;0;37
neos-3116779-oban;0;0.000000;0.000000;1;22;0;22
neos-3118745-obra;0;291.000000;-0.000000;3;4;0;4
neos-3148108-pahi;0;0.000000;0.000000;1;63;0;63
neos-3209462-rhin;0;0.000000;47.352227;2;4642;1;4643
neos-3209519-ruhr;0;332.850000;25.096416;1;45;0;45
neos-3214367-sovi;0;87807.062267;85.767665;1;1897;0;1897
neos-3216931-puriri;0;58817.360975;50.768945;1;796;0;796
neos-3226448-wkra;0;0.000000;512.043709;1;768;0;768
neos-3237086-abava;0;0.000000;56.000000;1;204;2;206
neos-3322547-alsek;0;616.000000;115.178534;2;10357;70;10427
neos-3352863-ancoa;0;43800.000000;-0.000000;3;873;16;889
neos-3354841-apure;0;48560.000000;3.800000;1;2156;23;2179
neos-3355120-tarago;0;-19761147.469026;129.355309;1;676;1;677
neos-3355323-arnon;0;0.000000;36.000000;3;67;2;69
neos-3372571-onahau;0;0.576990;8.695953;2;1102;0;1102
neos-3373491-avoca;0;21687686014.015354;20.812587;1;9;0;9
neos-3381206-awhea;0;432.000000;61.334767;2;5;0;5
neos-3402294-bobin;0;0.000000;49.310383;1;222;1;223
neos-3426085-ticino;0;235.000000;41.787470;3;28;0;28
neos-3426132-dieze;0;427.000000;103.670666;2;46;0;46
neos-3437289-erdre;0;0.000000;0.000000;1;63;0;63
neos-3530903-gauja;0;170.000000;33.253136;3;6;0;6
neos-3530905-gaula;0;153.000000;29.042208;2;3;0;3
neos-3555904-turama;0;-39.620698;1783.981601;2;5459;3;5462
neos-3572885-glina;0;0.000000;0.000000;1;76;1;77
neos-3581454-haast;0;1969.000000;47.338710;1;80;0;80
neos-3592146-hawea;0;7345804.855333;13.281253;1;40;0;40
neos-3594536-henty;0;383310.000000;1311.000000;1;74;1;75
neos-3603137-hoteo;0;0.000000;33.083333;3;40;1;41
neos-3610040-iskar;0;37.165417;2.262083;2;1;0;1
neos-3610051-istra;0;48.227558;5.104237;2;4;0;4
neos-3610173-itata;0;147.441250;3.692500;2;3;0;3
neos-3611447-jijia;0;116.645382;2.294795;2;2;0;2
neos-3611689-kaihu;0;138.382063;1.574126;2;2;0;2
neos-3615091-sutlej;0;-1506391.117177;161.684320;1;1706;8;1714
neos-3627168-kasai;0;1028641.180000;2.678667;2;3;0;3
neos-3634244-kauru;0;0.000000;152.720000;1;3755;3;3758
neos-3636886-kereu;0;1114.701601;0.001506;2;57;0;57
neos-3660371-kurow;0;286.534383;19.908718;1;15;0;15
neos-3661949-lesse;0;689000000.000000;0.000000;1;4;0;4
neos-3665875-lesum;0;248.325000;39.821583;2;82;0;82
neos-3682128-sandon;0;30098104.111687;108.126984;2;99;0;99
neos-3691541-lonja;0;-0.061575;9.639780;1;57;0;57
neos-3695882-vesdre;0;-145935.214286;39.000000;1;320;1;321
neos-3696678-lyvia;0;83.750000;63.000000;1;6;0;6
neos-3699377-maori;0;135877.224265;82.120524;2;106;0;106
neos-3703351-marne;0;317056.210386;73.319008;2;67;0;67
neos-3740487-motru;0;152.145486;76.975427;2;38541;65;38606
neos-3754480-nidda;0;-1216923.270104;12.186832;1;2;0;2
neos-3755335-nizao;0;50.030157;77.281035;2;561;1;562
neos-3759587-noosa;0;48.334468;4.240000;2;335;1;336
neos-3761878-oglio;0;422769.022545;66.971567;2;64;0;64
neos-3762025-ognon;0;603955.746492;47.328895;2;47;0;47
neos-4165869-wannon;0;285.150608;109.727085;2;539;1;540
neos-4230265-orari;0;38515515.684909;56.957317;3;2708;1;2709
neos-4260495-otere;0;3462.928116;162.093274;4;561;13;574
neos-4264598-oueme;0;4719412304.625630;65.571331;2;1988;0;1988
neos-4285819-pedja;0;34.451960;101.159938;2;284090;57;284147
neos-4290317-perth;0;3613303.634755;0.000000;2;1880;0;1880
neos-4295773-pissa;0;0.000000;1644.289474;1;5629;4;5633
neos-4300652-rahue;0;0.000000;32.000000;1;552;1;553
neos-4306827-ravan;0;-26673.307580;190.719995;2;340;4;344
neos-4321076-ruwer;0;1880.558333;39.333333;1;19691;1;19692
neos-4322846-ryton;0;0.419848;24.872919;1;685;5;690
neos-4332801-seret;0;233683.594384;172.099278;3;325;5;330
neos-4332810-sesia;0;-23062.998566;161.274117;3;298;5;303
neos-4333464-siret;0;24.688318;0.121324;2;12;0;12
neos-4333596-skien;0;-14653654.846569;0.746303;1;3;0;3
neos-4335793-snake;0;0.123684;141.753072;2;1275;1;1276
neos-4338804-snowy;0;1447.000000;20.890800;3;4;0;4
neos-4343293-stony;0;52.758728;0.200000;2;68;0;68
neos-4355351-swalm;0;33.854869;0.094819;2;172;3;175
neos-4358725-tagus;0;1889548.577948;203.435939;2;715;0;715
neos-4359986-taipa;0;0.395578;39.118149;1;1087;1;1088
neos-4360552-sangro;0;-29.500000;585.929612;1;8778;1;8779
neos-4387871-tavua;0;36.445048;0.200000;2;47;0;47
neos-4391920-timok;0;0.000378;34.957374;1;6548;5;6553
neos-4393408-tinui;0;340.267489;0.200000;2;46;0;46
neos-4408804-prosna;0;914.483516;71.708791;1;3025;1;3026
neos-4409277-trave;0;0.000000;350.162065;1;1741;1;1742
neos-4413714-turia;0;43.474651;375.032551;1;1718;11;1729
neos-4532248-waihi;0;0.370420;27.002838;1;4834;5;4839
neos-4533806-waima;0;3063.318841;49.500000;1;1002;5;1007
neos-4545615-waita;0;3606.594190;54.131913;1;17665;42;17707
neos-4555749-wards;0;3026.812121;34.982094;1;797;4;801
neos-4562542-watut;0;3743.304348;42.453118;1;2403;7;2410
neos-4647027-thurso;0;26911.641616;130.575703;1;2265;0;2265
neos-4647030-tutaki;0;26911.641616;131.360812;1;2739;0;2739
neos-4647032-veleka;0;26587.908699;174.943874;1;3455;0;3455
neos-4650160-yukon;0;-22633.302692;150.257047;1;5;0;5
neos-4722843-widden;0;63671.455263;748.515195;3;326;7;333
neos-4724674-aorere;0;3955.706101;89.034940;3;350;6;356
neos-4736745-arroux;0;262263446.114579;4.100609;2;33;0;33
neos-4738912-atrato;0;323678468.688703;3.843750;2;27;0;27
neos-4754521-awarau;0;0.000000;0.000000;1;1113;7;1120
neos-4760493-puerua;0;1908.243695;237.071976;1;32931;3;32934
neos-476283;0;406.244708;13.663873;1;6255;0;6255
neos-4763324-toguru;0;1120.986062;232.945926;1;32160;3;32163
neos-4797081-pakoka;0;0.000000;995.738455;1;6475;2;6477
neos-4805882-barwon;0;22058.983698;108.041076;3;204;1;205
neos-480878;0;515.138796;4.583278;2;18;0;18
neos-4954274-beardy;0;18659.208282;287.749893;2;1022;2;1024
neos-4954672-berkel;0;3491016.775148;2.808176;2;3;0;3
neos-4966258-blicks;0;366.090909;29.029987;2;1165;1;1166
neos-4971100-bodrog;0;0.000000;0.000000;1;46;0;46
neos-4972437-bojana;0;357.086296;28.918162;2;10351;2;10353
neos-4972461-bolong;0;466.511858;40.636307;2;6931;2;6933
neos-4976951-bunnoo;0;377.416466;25.855327;2;8183;2;8185
neos-4984115-canche;0;-9947088.084138;0.363560;1;12;0;12
neos-498623;0;16.283333;44.483796;1;72;0;72
neos-5013590-toitoi;0;1064.447092;169.000000;1;12606;1;12607
neos-5018451-chiese;0;-148612315.605332;10.652915;1;1449;0;1449
neos-503737;0;50.000000;47.918146;1;34;0;34
neos-5041822-cockle;0;5701464.927099;174.422554;3;917;3;920
neos-5044663-wairoa;0;4653100.000000;538.513042;1;17077;1;17078
neos-5045105-creuse;0;19.066671;18.227114;1;65;0;65
neos-5049753-cuanza;0;464.000000;46.400000;1;1973;2;1975
neos-5051588-culgoa;0;128.750000;30.632366;1;93;0;93
neos-5052403-cygnet;0;217.441067;86.382091;9;38058;177;38235
neos-506422;0;0.000000;5.671811;1;157;0;157
neos-506428;0;145945.000000;96.000000;1;1015;2;1017
neos-5075914-elvire;0;318.069363;54.936006;2;65;0;65
neos-5076235-embley;0;1930.000000;0.112088;2;489;0;489
neos-5078479-escaut;0;7438.416728;44.465727;2;52;0;52
neos-5079731-flyers;0;2004.000000;1.153846;2;475;0;475
neos-5083528-gimone;0;0.000000;14.500000;1;222;3;225
neos-5093327-huahum;0;3934.000000;1.858333;2;454;0;454
neos-5100895-inster;0;2084.000000;3.428571;2;283;0;283
neos-5102383-irwell;0;1740.000000;2.593407;2;518;0;518
neos-5104907-jarama;0;648.590198;45.766769;2;8484;3;8487
neos-5106984-jizera;0;721.000000;2.214286;2;2838;4;2842
neos-5107597-kakapo;0;0.000000;0.591250;2;35;0;35
neos-5108386-kalang;0;621.655661;44.224657;2;16447;5;16452
neos-5114902-kasavu;0;518.000000;86.666667;2;8440;9;8449
neos-5115478-kaveri;0;0.000000;0.529375;2;29;0;29
neos-5116085-kenana;0;452.000000;75.333333;1;5669;4;5673
neos-5118834-korana;0;583.521384;84.694364;2;12483;4;12487
neos-5118851-kowhai;0;1134.000000;4.250000;2;3628;5;3633
neos-5123665-limmat;0;654.150497;46.028000;2;23732;6;23738
neos-5125849-lopori;0;0.000000;5.984639;1;34;0;34
neos-5129192-manaia;0;0.000000;10.000000;1;3036;11;3047
neos-5138690-middle;0;609.154239;78.594258;2;26162;5;26167
neos-5140963-mincio;0;8877.000000;2.142857;1;1;0;1
neos-5149806-wieprz;0;45.000000;8.017612;3;391;8;399
neos-5151569-mologa;0;686014018.994230;29.077013;2;3264;2;3266
neos-5178119-nalagi;0;8.569859;22.862578;2;96;0;96
neos-5182409-nasivi;0;0.000000;19.823533;1;7;0;7
neos-5188808-nattai;0;0.000000;12.650607;1;496;0;496
neos-5189128-totara;0;330131.390743;21.863581;1;1035;3;1038
neos-5192052-neckar;0;-11980000.000000;0.400000;2;0;0;0
neos-5193246-nerang;0;0.000000;411.508334;1;228;0;228
neos-5195221-niemur;0;0.000000;330.122640;1;398;1;399
neos-5196530-nuhaka;0;0.000000;423.701932;1;223;0;223
neos-520729;0;-1389625.000000;6.812619;1;539;1;540
neos-5221106-oparau;0;0.000000;33.949758;1;692;1;693
neos-525149;0;60.000000;40.416667;1;61;0;61
neos-5260764-orauea;0;58748.022532;8.725559;1;73;0;73
neos-5261882-treska;0;26047.998000;6.157765;1;7;0;7
neos-5266653-tugela;0;21659.678723;20.155553;1;150;1;151
neos-555001;0;962625.000000;32.414286;1;10;0;10
neos-555343;0;1346700.000000;157.193056;4;15;0;15
neos-555424;0;1286800.000000;144.027778;1;46;0;46
neos-555884;0;1112400.000000;165.150000;1;37;0;37
neos-565672;0;55015.268433;57.351362;4;16883;21;16904
neos-574665;0;5932913.752734;8.390264;3;6;0;6
neos-578379;0;0.000000;99.662118;1;1685;0;1685
neos-585192;0;384.328979;0.433130;2;11;0;11
neos-585467;0;347.224531;0.316538;2;8;0;8
neos-595904;0;61213.471080;16.893904;2;86;0;86
neos-619167;0;1.481241;35.779031;1;110;0;110
neos-631517;0;7085534.224616;53.184659;2;8;0;8
neos-631710;0;286.000000;225.464535;2;866;19;885
neos-633273;0;6996841097.997801;0.000000;1;131;0;131
neos-662469;0;184342.980720;94.063832;1;429;1;430
neos-686190;0;5134.813830;17.515957;1;97;0;97
neos-691058;0;263.400000;89.042857;1;147;0;147
neos-693347;0;234.000000;81.086990;1;651;0;651
neos-738098;0;-1099.000000;191.756045;1;220;0;220
neos-777800;0;-80.000000;72.948470;1;63;0;63
neos-780889;0;3421500.000000;0.000000;1;343;5;348
neos-787933;0;30.000000;0.000000;1;1;0;1
neos-799711;0;-11228065.153797;80.726082;1;648;0;648
neos-799716;0;4932670.661692;20.807498;1;48;0;48
neos-807639;0;332.924117;12.512286;1;7;0;7
neos-820879;0;24874.267857;63.030000;1;79;0;79
neos-824661;0;55.000000;94.965217;2;240;1;241
neos-824695;0;43.000000;61.571429;2;104;0;104
neos-826224;0;124.000000;43.333333;2;188;2;190
neos-826650;0;32.000000;154.916667;2;42;0;42
neos-826694;0;72.000000;221.851190;2;109;1;110
neos-826812;0;69.011000;175.561360;3;115;1;116
neos-826841;0;32.008200;127.466667;2;35;0;35
neos-827015;0;2.098071;332.649497;1;1574;2;1576
neos-827175;0;115.001520;111.833333;2;161;1;162
neos-829552;0;2.098071;248.920991;1;1552;1;1553
neos-831188;0;1.767720;87.466667;1;58;0;58
neos-847302;0;-0.000000;46.994734;1;47;0;47
neos-848198;0;168977.000000;-0.000000;2;165;0;165
neos-848589;0;0.000000;1.000000;1;1193;1;1194
neos-849702;0;0.000000;85.488277;1;22;0;22
neos-850681;0;2087.000000;51.800000;1;97;0;97
neos-860300;0;2035.362225;9.000000;1;40;0;40
neos-872648;0;52.570282;0.000000;2;999;7;1006
neos-873061;0;135.208828;0.000000;2;1084;7;1091
neos-876808;0;169615.062608;275.400000;2;2552;1;2553
neos-885086;0;-243.000000;18.235808;2;204;0;204
neos-885524;0;12397.479000;5.525486;3;68;2;70
neos-911880;0;23.260000;17.096042;1;2;0;2
neos-911970;0;23.260000;17.457173;1;2;0;2
neos-913984;0;1000.000000;35.192618;1;174;2;176
neos-914441;0;5660364.283770;87.286515;1;2015;0;2015
neos-916792;0;26.283217;17.068306;2;119;0;119
neos-932721;0;513000.000000;-0.000000;2;61;0;61
neos-932816;0;513000.000000;0.000000;2;149;0;149
neos-933562;0;0.000000;82.687196;1;26;0;26
neos-933638;0;472008.000000;0.000000;2;156;1;157
neos-933966;0;448020.000000;-0.000000;2;122;1;123
neos-934278;0;448010.000000;-0.000000;2;277;1;278
neos-935234;0;436011.000000;0.000000;2;287;1;288
neos-935627;0;23250.000000;0.000000;2;325;0;325
neos-935769;0;23430.000000;0.000000;2;331;0;331
neos-937511;0;52640.000000;-0.000000;2;363;1;364
neos-937815;0;53890.000000;-0.000000;2;438;1;439
neos-941262;0;51923.000000;-0.000000;2;352;0;352
neos-941313;0;9361.000000;268.471014;1;528;4;532
neos-942830;0;12.000000;69.105641;2;26;0;26
neos-948126;0;52602.000000;-0.000000;2;348;1;349
neos-948346;0;-194.100000;16.214139;6;433;23;456
neos-950242;0;2.000000;42.000000;2;105;1;106
neos-953928;0;-8.906667;12.942467;4;137;4;141
neos-954925;0;-156.787389;21.891636;4;346;12;358
neos-956971;0;-97.788318;24.467911;4;456;11;467
neos-957143;0;-185.847699;34.060881;5;503;15;518
neos-957323;0;-218.785116;18.500000;3;284;9;293
neos-957389;0;1.500000;23.833333;1;75;1;76
neos-960392;0;-238.000000;301.558442;1;249;2;251
neos-983171;0;52403.000000;0.000000;2;378;0;378
neos-984165;0;51812.000000;0.000000;2;363;1;364
neos13;0;-126.178378;41.501658;2;177;0;177
neos15;0;143201.242910;0.000000;2;2;0;2
neos16;0;429.000000;13.190476;3;4;0;4
neos17;0;0.222688;0.000000;2;6;0;6
neos18;0;12.000000;47.166667;5;70;0;70
neos2;0;-4407.097239;5.158588;1;4;0;4
neos22;0;792540.000000;11.064286;2;32;0;32
neos5;0;17.250000;0.000000;2;1;0;1
neos6;0;114.038055;32.275044;6;310;6;316
neos8;0;-3309.500000;20.750000;3;23;0;23
neos808444;0;0.000000;225.341563;1;301;1;302
neos9;0;780.000000;44.250000;1;308;0;308
net12;0;47.514236;134.516319;3;972;0;972
netdiversion;0;453.800000;766.600000;2;7428;10;7438
newdano;0;11.724138;8.447296;1;2;0;2
nexp-150-20-1-5;0;74.000000;-0.000000;3;35;0;35
nexp-150-20-8-5;0;552.000000;0.000000;3;69;1;70
nexp-50-20-1-1;0;35.000000;-0.000000;2;0;0;0
nexp-50-20-4-2;0;120.000000;0.000000;2;2;0;2
nh97_potential;0;1462.000000;74.900000;2;5;0;5
nh97_tension;0;1429.000000;76.466667;2;1;0;1
nj1;0;0.000000;607.000000;1;461;1;462
nj2;0;0.000000;607.000000;1;665;1;666
nj3;0;0.000000;607.000000;1;1522;1;1523
nobel-eu-DBE;0;7363863.000000;1.290278;2;73;0;73
noswot;0;-39.920111;4.557455;3;0;0;0
ns1111636;0;96.250000;17.588542;1;267;1;268
ns1116954;0;0.000000;154.227320;1;723;1;724
ns1208400;0;0.000000;103.355904;1;35;0;35
ns1430538;0;73.621609;10.144494;1;402;0;402
ns1456591;0;361.939022;19.000000;1;113;0;113
ns1606230;0;13.225000;183.303928;1;1890;0;1890
ns1631475;0;94800.000000;643.196596;2;1289;2;1291
ns1679495;0;3355407.151677;106.229642;2;45905;10;45915
ns1685374;0;-51.800913;96.218654;1;2243;1;2244
ns1688347;0;2.259259;29.881974;1;246;0;246
ns1690781;0;-1022.227789;60.056795;2;93;0;93
ns1696083;0;2.038462;48.811865;1;513;1;514
ns1758913;0;-1473.311978;85.635340;1;8192;5;8197
ns1760995;0;-1349.487943;142.000000;1;15546;8;15554
ns1778858;0;-22635740.000000;227.465047;2;289;0;289
ns1828997;0;0.000000;75.000000;1;993;1;994
ns1830653;0;7083.000000;57.878444;1;82;0;82
ns1849932;0;546.000000;5.620915;1;1056;6;1062
ns1853823;0;1172000.000000;1345.731857;2;42959;22;42981
ns1854840;0;1664000.000000;1124.615817;2;8776;15;8791
ns1856153;0;0.000000;202.811888;2;185;1;186
ns1904248;0;0.000000;476.666667;3;2465;7;2472
ns1905797;0;11.750980;32.426504;1;222;1;223
ns1905800;0;6.436600;26.487503;1;42;0;42
ns1952667;0;0.000000;9.316422;1;178;1;179
ns2017839;0;77026841466348.453125;1.620352;2;5838;0;5838
ns2034125;0;24740.000000;384.382319;2;2834;0;2834
ns2071214;0;0.000000;42.334331;1;67;0;67
ns2081729;0;4.600000;0.220500;2;2;0;2
ns2122698;0;62785.622771;196.156523;1;348;0;348
ns2124243;0;53998.333333;198.222222;1;246;1;247
ns2137859;0;24629.000000;56.954851;1;105;0;105
ns4-pr3;0;711323.000000;0.000000;2;142;0;142
ns4-pr6;0;395464.500000;0.000000;2;31;0;31
ns4-pr9;0;497175.000000;0.000000;2;76;0;76
ns894236;0;18.000000;109.321441;2;224;0;224
ns894244;0;16.000000;176.636636;2;538;1;539
ns894786;0;14.000000;98.226662;2;503;2;505
ns894788;0;7.000000;55.330051;2;86;0;86
ns903616;0;22.000000;175.549922;2;458;1;459
nsa;0;91.855632;7.418401;2;6;0;6
nsr8k;0;17500809.511815;639.895001;1;8839;2;8841
nsrand-ipx;0;68640.000000;0.000000;3;50;1;51
nu120-pr12;0;197775.000000;4.800000;2;40;0;40
nu120-pr3;0;511253.750000;28.016727;2;110;0;110
nu120-pr9;0;334880.000000;15.750000;2;82;0;82
nu25-pr12;0;297882.500000;4.233333;2;43;0;43
nu4-pr9;0;497175.000000;9.713333;2;73;0;73
nu60-pr9;0;386150.000000;12.150000;2;76;0;76
nucorsav;0;29.046100;79.666667;1;71626;136;71762
nursesched-medium-hint03;0;33.468485;463.947617;1;1141;3;1144
nursesched-medium04;0;316.000000;243.500000;2;757;5;762
nursesched-sprint-hidden09;0;516.944444;178.989683;2;334;2;336
nursesched-sprint-late03;0;34.254806;182.557279;1;344;1;345
nursesched-sprint02;0;134.416667;117.833333;2;217;2;219
nw04;0;16310.666667;2.000000;1;186;3;189
ofi;0;6135598681.449045;1321.867570;196;3595;90;3685
ofi2;0;6128453035.160096;1604.443623;184;6846;150;6996
oocsp-racks030e6cci;0;0.000000;530.191752;15;164;12;176
opm2-z10-s2;0;-21344.000000;-0.000000;5;6940;7;6947
opm2-z10-s4;0;-20011.000000;-0.000000;5;6935;6;6941
opm2-z11-s8;0;-24077.000000;0.000000;5;10729;9;10738
opm2-z12-s14;0;-38546.000000;-0.000000;5;24787;15;24802
opm2-z12-s7;0;-33919.000000;-0.000000;5;26119;11;26130
opm2-z12-s8;0;-35083.000000;0.000000;6;27133;13;27146
opm2-z6-s1;0;-2356.000000;-0.000000;3;263;0;263
opm2-z7-s2;0;-7132.000000;-0.000000;4;527;1;528
opm2-z7-s8;0;-6856.000000;-0.000000;4;525;1;526
opm2-z8-s0;0;-8004.000000;0.000000;3;1300;1;1301
opt1217;0;-20.021390;8.759358;1;2;0;2
osorio-cta;0;0.000000;0.013388;1;50;0;50
p0201;0;7155.000000;10.900000;1;1;0;1
p100x588b;0;58977.000000;0.000000;2;1;0;1
p200x1188c;0;15747.000000;0.000000;2;2;0;2
p2756;0;2706.000000;24.070313;2;4;0;4
p500x2988;0;72594.000000;0.000000;2;28;0;28
p500x2988c;0;17212.000000;-0.000000;2;26;0;26
p500x2988d;0;6.000000;-0.000000;2;25;0;25
p6b;0;-53.000000;0.000000;3;49;0;49
p80x400b;0;45896.000000;-0.000000;2;1;0;1
pb-fit2d;0;-22363.768555;843.273209;1;8068;14;8082
pb-gfrd-pnc;0;8321.694589;42.993642;1;148;0;148
pb-grow22;0;-449654.852582;117.814534;1;479;1;480
pb-market-split8-70-4;0;0.000000;1.843507;1;0;0;0
pb-simp-nonunif;0;9.500000;316.333333;3;2749;8;2757
peg-solitaire-a3;0;1.000000;284.160673;1;366;0;366
pg;0;-11098.657382;17.215049;2;5;0;5
pg5_34;0;-16012.248077;18.476238;2;6;0;6
physiciansched3-3;0;2590923.193775;699.205074;3;17707;4;17711
physiciansched3-4;0;1459296.261635;504.324571;3;9475;3;9478
physiciansched5-3;0;20464.000000;133.462963;2;710;0;710
physiciansched6-1;0;11546.864508;412.159264;16;620;9;629
physiciansched6-2;0;47675.160783;435.646407;4;339;1;340
pigeon-08;0;-8000.000000;4.485714;1;1;0;1
pigeon-10;0;-10000.000000;8.022222;1;2;0;2
pigeon-11;0;-11000.000000;9.020000;1;2;0;2
pigeon-12;0;-12000.000000;10.018182;1;2;0;2
pigeon-13;0;-13000.000000;11.016667;1;3;0;3
pigeon-16;0;-16000.000000;34.984242;1;4;0;4
pigeon-19;0;-19000.000000;17.011111;1;5;0;5
pigeon-20;0;-20000.000000;26.250718;1;6;0;6
piperout-03;0;69590.490975;267.052209;27;255;8;263
piperout-08;0;99228.924471;296.271739;11;225;4;229
piperout-27;0;7146.876623;508.355093;59;364;25;389
piperout-d20;0;25601.416667;437.748324;2;705;1;706
piperout-d27;0;7199.340391;682.880995;2;830;1;831
pk1;0;0.000000;2.782038;1;0;0;0
polygonpack3-15;0;-114051612.169520;43.997815;3;945;5;950
polygonpack4-10;0;-93676953.470100;19.422012;3;373;2;375
polygonpack4-15;0;-114052801.790860;41.081462;3;1083;5;1088
polygonpack4-7;0;-75324958.874200;9.351513;3;192;1;193
polygonpack5-15;0;-66029981.130960;32.423595;3;1203;5;1208
pp08a;0;15000.000000;-0.000000;2;0;0;0
pp08aCUTS;0;16630.402442;0.000000;2;2;0;2
probportfolio;0;7.321966;24.067729;1;2;0;2
prod1;0;-55.000000;3.767946;2;2;0;2
prod2;0;-59.000000;4.566580;2;4;0;4
proteindesign121hz512p19;0;3197.772133;54.952462;1;5511;60;5571
proteindesign121hz512p9;0;1423.904449;59.959446;1;203;3;206
proteindesign121pgb11p9;0;1173.710433;48.788284;1;180;3;183
proteindesign122trx11p8;0;1720.461105;42.058897;1;198;3;201
protfold;0;-0.000000;35.000000;2;22;0;22
pw-myciel4;0;4.000000;93.664980;4;6;0;6
pythago7824;0;0.000000;580.777778;6;836;2;838
pythago7825;0;0.000000;586.777778;8;750;3;753
qap10;0;332.566228;55.000000;1;331;0;331
qiu;0;1805.177158;0.000000;2;5;0;5
qnet1;0;89045.940000;7.221868;2;19;0;19
qnet1_o;0;93221.720000;0.000000;2;5;0;5
queens-30;0;-30.000000;0.000000;3;188;1;189
r4l4-02-tree-bounds-50;0;512370030.000000;648.050000;3;40;0;40
r50x360;0;2016.000000;-0.000000;2;1;0;1
r80x800;0;5520.000000;-0.000000;2;2;0;2
radiationm18-12-05;0;17561.353680;198.621204;2;59;0;59
radiationm40-10-02;0;155317.684921;719.665741;2;300;2;302
rail01;0;-90.767086;1608.708333;1;14057;4;14061
rail02;0;-206.092110;2201.000000;1;125638;9;125647
rail03;0;-919.222126;7597.965972;1;186450;24;186474
rail507;0;207.000000;-0.000000;3;218;3;221
railway_8_1_0;0;397.000000;47.625401;3;4;0;4
ramos3;0;440.000000;-0.000000;3;1445;0;1445
ran12x21;0;4080.000000;0.000000;2;0;0;0
ran13x13;0;3521.000000;0.000000;2;0;0;0
ran14x18-disj-8;0;12170.996653;0.000000;2;17;0;17
ran14x18;0;4265.000000;0.000000;2;0;0;0
ran16x16;0;4333.000000;0.000000;2;0;0;0
rd-rplusc-21;0;100.000000;4.459580;1;323;0;323
reblock115;0;-37981832.798944;238.100873;1;247;0;247
reblock166;0;-640892721.079106;86.859092;6;300;0;300
reblock354;0;-39586262.751951;411.245436;1;952;0;952
reblock420;0;-558825455.521724;213.947318;7;1519;3;1522
reblock67;0;-36575497.117631;131.415935;1;40;0;40
rfds-4-days;0;-1158940.978167;68.309524;1;20228;10;20238
rlp1;0;13.244444;9.961905;1;1;0;1
rmatr100-p10;0;360.593308;9.692735;1;279;0;279
rmatr100-p5;0;762.040054;5.000000;1;476;0;476
rmatr200-p10;0;1550.620783;10.000000;1;11275;0;11275
rmatr200-p20;0;688.357943;19.982266;1;3558;0;3558
rmatr200-p5;0;3283.653831;5.000000;1;12250;0;12250
rmine10;0;-1926.863820;886.708002;1;3653;1;3654
rmine11;0;-2522.047107;1304.350285;1;9228;1;9229
rmine13;0;-3504.619914;1108.274293;2;26401;5;26406
rmine14;0;-4310.694704;2228.265999;1;116116;4;116120
rmine15;0;-5042.482963;4267.046917;1;216665;5;216670
rmine6;0;-462.305727;106.725097;1;113;0;113
rocI-3-11;0;-110705.000000;58.061873;15;10;0;10
rocI-4-11;0;-11110705.000000;73.949250;17;38;1;39
rocII-10-11;0;-11.946851;225.450859;1;539;1;540
rocII-4-11;0;-11.867128;49.198977;2;51;0;51
rocII-5-11;0;-11.893702;59.199453;2;69;0;69
rocII-7-11;0;-11.924073;130.743159;2;195;1;196
rocII-8-11;0;-11.933564;156.556814;2;270;1;271
rocII-9-11;0;-11.940946;191.769497;1;515;0;515
rococoB10-011000;0;51207.000000;10.950589;5;130;0;130
rococoC10-001000;0;23730.000000;0.000000;6;22;0;22
rococoC11-010100;0;143170.000000;22.416868;2;147;0;147
rococoC11-011100;0;139407.000000;14.937663;2;107;0;107
rococoC12-010001;0;117774.000000;9.895179;2;177;1;178
rococoC12-111000;0;27337.357381;31.147270;1;220;0;220
roi2alpha3n4;0;-78.888089;8.000000;2;643;8;651
roi5alpha10n8;0;-84.342241;16.000000;2;1979;25;2004
roll3000;0;11939.645814;52.881579;2;24;0;24
rout;0;981.864286;10.233819;1;2;0;2
rpp22falsei;0;0.000000;74.127711;3;64;1;65
rvb-sub;0;11.206514;4.857143;1;740;5;745
s100;0;-0.170525;28.899744;1;21394;16;21410
s1234;0;0.361925;1.572096;4;1830;0;1830
s250r10;0;-0.165732;41.814334;2;8894;29;8923
s55;0;-22.151773;60.323192;1;1653;4;1657
satellites1-25;0;-20.000000;105.238724;1;759;0;759
satellites2-25;0;-29.000000;479.882873;1;29672;2;29674
satellites2-40;0;-29.000000;351.367725;1;30607;2;30609
satellites2-60-fs;0;-24.082986;445.038080;2;3819;2;3821
satellites2-60;0;-29.000000;351.367725;1;31533;2;31535
satellites3-25;0;-38.000000;750.228870;1;241091;5;241096
satellites3-40-fs;0;-32.574097;833.681612;2;27204;6;27210
satellites3-40;0;-38.000000;724.976718;1;258462;5;258467
savsched1;0;8350.766667;0.000000;3;63505;47;63552
scpj4scip;0;183.000000;-0.000000;3;1354;24;1378
scpk4;0;389.000000;0.000000;3;2855;23;2878
scpl4;0;360.000000;-0.000000;3;4891;46;4937
scpm1;0;774.000000;0.000000;3;46209;133;46342
scpn2;0;741.000000;0.000000;3;71726;276;72002
sct1;0;-186.838854;85.284884;2;988;1;989
sct2;0;-42.788075;14.732262;2;50;0;50
sct31;0;177.483592;23.157091;2;231;0;231
sct32;0;51.266438;45.043874;2;536;1;537
sct5;0;-227.069807;28.088069;2;523;2;525
seqsolve1;0;4770.293168;265.188388;24;6664;132;6796
seqsolve2short4288;0;20.396875;318.804378;4;6823;25;6848
seqsolve3short4288excess384;0;-43472.799518;407.473201;8;10822;42;10864
set1ch;0;107691.500000;-0.000000;2;1;0;1
set3-09;0;1263.077974;13.704533;2;10;0;10
set3-10;0;788.890655;13.953500;2;9;0;9
set3-15;0;8364.040745;17.366709;2;15;0;15
set3-16;0;9916.808562;19.040932;2;20;0;20
set3-20;0;10347.381087;16.724301;2;11;0;11
seymour-disj-10;0;331.000001;-0.000000;4;1725;2;1727
seymour;0;452.000000;0.000000;3;257;0;257
seymour1;0;419.891318;-0.000000;3;226;0;226
shiftreg1-4;0;131.656032;154.593750;1;34;0;34
shiftreg2-7;0;206.733052;125.342690;1;76;0;76
shiftreg5-1;0;520.839888;536.473506;1;332;0;332
shipsched;0;-0.000000;8.077417;4;83;1;84
shipschedule3shipsi;0;-265650.000000;344.868882;12;53;2;55
shipschedule6shipsmixi;0;-301650.000000;708.087219;10;94;3;97
shipschedule8shipsmixuci;0;-401100.000000;525.089709;11;92;5;97
shs1014;0;22137.410363;320.475000;1;38579;19;38598
shs1042;0;10404.662711;568.781970;1;35295;19;35314
siena1;0;10163179.229002;146.859338;1;1437;1;1438
sing11;0;18640171.224643;243.132649;1;7007;4;7011
sing161;0;19071259.113926;685.480441;1;73477;23;73500
sing17;0;35483848.876513;472.456436;1;28291;11;28302
sing2;0;17150914.716940;256.737979;1;1789;1;1790
sing245;0;25024015.754083;395.965975;1;13135;6;13141
sing326;0;7717674.801189;172.968798;1;2463;2;2465
sing359;0;22534478.962498;889.129081;1;89586;19;89605
sing44;0;8102513.219400;139.469372;1;3226;2;3228
sing5;0;18418516.013137;236.754039;1;2891;3;2894
snip10x10-35r1budget17;0;30.000000;3.224794;2;1363;0;1363
snp-02-004-104;0;567161691.779774;7.604965;5;5633;0;5633
snp-04-052-052;0;746313354.490274;733.799382;6;4544;3;4547
snp-06-004-052;0;1831976376.522612;31.156229;2;8472;0;8472
snp-10-004-052;0;5961214167.823297;42.379535;6;20836;2;20838
snp-10-052-052;0;6009206679.336597;1683.882989;6;21979;9;21988
sorrell3;0;-13.000000;-0.000000;3;379;0;379
sorrell4;0;-18.000000;-0.000000;3;954;2;956
sorrell7;0;-141.000000;0.000000;3;14898;0;14898
sorrell8;0;-269.000000;0.000000;3;189;0;189
sp150x300d;0;71.000000;0.000000;2;0;0;0
sp97ar;0;815120355.519999;2.342794;4;415;5;420
sp97ic;0;578703486.755542;0.975543;3;362;5;367
sp98ar;0;648426163.072905;1.440725;4;518;9;527
sp98ic;0;605964163.117924;3.283712;5;481;7;488
sp98ir;0;271833089.651983;6.757325;5;55;1;56
splice1k1;0;-3.068619;1.426914;2;34709;19;34728
splice1k1i;0;-1646.777979;134.969052;1;13584;3;13587
square23;0;8.333333;12.444444;1;82;1;83
square31;0;8.500000;13.750000;1;472;4;476
square37;0;8.666667;13.666667;1;1131;9;1140
square41;0;8.839612;15.068891;1;2643;16;2659
square47;0;8.755814;15.976744;1;8602;31;8633
stoch-vrpvrp-s5v2c8vrp-v2c8i;0;0.000000;87.482236;2;12;0;12
stockholm;0;166.000000;0.000000;2;414;0;414
stp3d;0;564.338735;444.504657;2;24456;13;24469
sts405;0;357.000000;0.000000;2;564;2;566
sts729;0;665.000000;0.000000;2;3576;6;3582
supportcase1;0;20078.000000;0.020832;2;263;7;270
supportcase10;0;3.383924;971.624635;2;9541;4;9545
supportcase11;0;-14.281996;0.000000;1;2;0;2
supportcase12;0;-7559.533054;68.692550;1;1750;0;1750
supportcase14;0;272.000000;7.333333;1;1;0;1
supportcase16;0;272.000000;7.333333;1;1;0;1
supportcase17;0;0.000000;20.311619;2;6;0;6
supportcase18;0;87.000000;9.141806;2;39;0;39
supportcase19;0;12677206.000000;370.390975;1;26210;64;26274
supportcase2;0;0.000000;4.750000;1;9272;50;9322
supportcase20;0;108889.000000;0.000000;2;13;0;13
supportcase23;0;-12952.000000;617.629502;1;1748;0;1748
supportcase25;0;0.036932;10.888511;1;92;0;92
supportcase26;0;1288.102161;0.009948;2;1;0;1
supportcase27i;0;0.000000;80.548714;2;7;0;7
supportcase3;0;0.000000;403.282880;3;214;1;215
supportcase30;0;0.000000;102.857020;1;68;0;68
supportcase31;0;79524.180000;4.000000;2;1892;72;1964
supportcase33;0;-465.000000;28.823216;2;137;0;137
supportcase34;0;72.664116;173.934717;1;432;1;433
supportcase35;0;174371.000000;0.000000;2;87;0;87
supportcase37;0;-5803.552159;23.221484;2;920;0;920
supportcase39;0;-1062330.369524;22.808785;5;87;7;94
supportcase4;0;0.000000;202.915359;3;166;0;166
supportcase40;0;22536.483379;19.000000;1;274;0;274
supportcase41;0;28.000000;42.562945;2;902;0;902
supportcase42;0;7.343539;48.081295;1;1629;2;1631
supportcase43;0;0.000000;48.147044;2;52449;3;52452
supportcase6;0;45090.732163;29.123967;1;1904;13;1917
supportcase7;0;-2396.218213;53.147310;2;1677;0;1677
swath;0;334.496858;2.200000;1;40;0;40
swath1;0;334.496858;0.600000;1;31;0;31
swath2;0;334.496858;0.700000;1;32;0;32
swath3;0;334.496858;0.800000;1;32;0;32
t1717;0;134531.021428;79.098998;1;210;1;211
t1722;0;98815.407611;52.399108;1;121;0;121
ta1-UUM;0;3693674.556772;4.303412;1;4;0;4
ta2-UUE;0;41427354.755773;0.680983;2;144;0;144
tanglegram1;0;0.000000;46.000000;1;2;0;2
tanglegram2;0;1.000000;26.500000;1;1;0;1
tanglegram4;0;4.000000;71.000000;1;4;0;4
tanglegram6;0;0.000000;33.500000;1;1;0;1
tbfp-bigm;0;-178.153988;30.000000;1;131;0;131
tbfp-network;0;23.261535;31.000000;1;841;4;845
Test3;0;2671255.210245;12.061384;1;113;0;113
thor50dday;0;203930.000000;0.000000;2;238;4;242
timtab1;0;1219185.333333;17.766667;2;1;0;1
timtab1CUTS;0;613590.095426;34.399586;2;3;0;3
timtab2;0;1602354.333333;29.200000;2;1;0;1
tokyometro;0;4661.136055;270.699215;3;68;0;68
toll-like;0;28.000000;229.000000;1;30;0;30
tpl-tub-ss16;0;8128588.328716;1889.575939;3;87379;145;87524
tpl-tub-ws1617;0;10755112.807538;2191.381057;3;102234;184;102418
tr12-30;0;188435.464884;3.580258;2;1;0;1
traininstance2;0;0.000000;8.034883;2;39;0;39
traininstance6;0;0.000000;3.486662;2;31;0;31
transportmoment;0;-55084931301.156029;426.403696;2;184;0;184
trento1;0;5182758.848056;77.237488;1;601;0;601
triptim1;0;22.927100;1744.894737;3;7379;8;7387
triptim2;0;11.889797;542.834787;3;10694;7;10701
triptim3;0;14.144151;636.713323;3;9685;7;9692
triptim4;0;9.552100;369.397727;3;9976;8;9984
triptim7;0;3088.288157;498.350855;2;12340;6;12346
triptim8;0;3074.310409;495.273425;2;14016;5;14021
tw-myciel4;0;22.000000;72.075704;6;180;1;181
uc-case11;0;611621.305979;114.829952;1;2672;0;2672
uc-case3;0;7181.432113;95.258578;3;1869;1;1870
uccase10;0;38995.965187;400.440843;1;2633;2;2635
uccase12;0;11507.474829;29.321333;3;2249;3;2252
uccase7;0;26527.823515;162.338874;1;3520;0;3520
uccase8;0;11142.163196;63.982247;1;1473;0;1473
uccase9;0;10819.582996;76.021210;1;1082;0;1082
uct-subprob;0;242.000000;58.243175;1;62;0;62
umts;0;43380098.519492;76.628947;2;34;0;34
unitcal_7;0;19450489.742819;144.660904;6;783;1;784
usAbbrv-8-25_70;0;95.000000;103.341847;3;7;0;7
usafa;0;178.602081;3104.483345;2;48310;28;48338
v150d30-2hopcds;0;52.000000;-0.000000;3;109;1;110
van;0;3.717453;12.910186;1;8517;0;8517
var-smallemery-m6j6;0;-156.056268;89.220998;2;1017;4;1021
vpm2;0;15.721505;3.393512;2;0;0;0
vpphard;0;0.000000;131.849958;1;71;1;72
vpphard2;0;0.000000;239.681095;1;77;0;77
wachplan;0;-9.000000;58.858491;1;11;0;11
wnq-n100-mw99-14;0;224.318143;77.196581;2;128;0;128
xmas10-2;0;-537.008669;157.129457;1;216;0;216
xmas10;0;-537.008669;157.318400;1;175;0;175
z26;0;-982.000000;-0.000000;3;12528;8;12536
zeil;0;813.510308;818.615660;1;90113;6;90119
zib54-UUE;0;19164366.000000;-0.000000;2;51;0;51
10teams;37029;917.000000;36.681642;1;32;0;32
22433;37029;21552.708079;24.962328;5;5;0;5
23588;37029;8342.863244;17.617619;4;4;0;4
2club200v15p5scn;37029;-98.397436;37.935897;4;137;2;139
30n20b8;37029;5530.000000;41.625765;2;143;0;143
30_70_45_05_100;37029;67.000000;-0.000000;5;926;2;928
30_70_45_095_100;37029;48.000000;-0.000000;5;1047;3;1050
30_70_45_095_98;37029;110.000000;-0.000000;5;1056;2;1058
50v-10;37029;1493601.476062;-0.000000;2;5;0;5
a1c1s1;37029;20885.065088;0.498062;2;9;0;9
a2c1s1;37029;21087.746318;-0.000000;2;9;0;9
ab51-40-100;37029;-437558462.000004;11.050000;2;501;1;502
ab67-40-100;37029;-11186253442.000000;0.000000;1;345;0;345
ab69-40-100;37029;-11186281442.000000;0.000000;1;298;0;298
ab71-20-100;37029;-2390446504.400002;12.500000;2;232;0;232
ab72-40-100;37029;-11186620442.000000;0.000000;1;339;0;339
academictimetablebig;37029;427.000000;1980.203197;2;38398;17;38415
academictimetablesmall;37029;0.000000;304.037692;2;216;3;219
acc-tight2;37029;0.000000;120.187623;1;25;0;25
acc-tight4;37029;0.000000;120.929764;1;22;0;22
acc-tight5;37029;0.000000;108.861099;1;189;0;189
acc-tight6;37029;0.000000;100.822653;1;214;0;214
adult-max5features;37029;10710.000597;0.023689;2;893;7;900
adult-regularized;37029;7841.000000;0.000000;3;2033;9;2042
aflow30a;37029;1402.717622;2.301497;3;1;0;1
aflow40b;37029;1129.417647;2.760099;3;7;0;7
air03;37029;338864.250000;11.375000;1;56;0;56
air04;37029;55535.436388;51.829962;1;195;0;195
air05;37029;25877.609268;45.880497;1;131;0;131
aligninq;37029;2755.000000;40.921868;7;15;1;16
allcolor10;37029;1667.205949;277.752404;3;94;1;95
allcolor58;37029;6860.683036;1871.573531;3;633;8;641
amaze22012-03-15i;37029;0.000000;58.180281;2;87;2;89
amaze22012-06-28i;37029;0.000000;35.393465;2;26;0;26
amaze22012-07-04i;37029;0.000000;40.505587;2;42;0;42
app1-1;37029;-2.000000;1.945752;2;6;0;6
app1-2;37029;-23.000000;1.399234;3;305;1;306
app2-1;37029;19294.250000;0.000000;2;19;0;19
app2-2;37029;212092.500000;0.000000;2;1;0;1
app3;37029;5627412.287938;3.142492;1;8;0;8
arki001;37029;7579621.830840;15.454670;1;31;0;31
assign1-10-4;37029;353.992926;52.000000;1;35;0;35
assign1-5-8;37029;183.362555;24.000000;1;2;0;2
atlanta-ip;37029;81.321096;294.518627;2;5526;2;5528
atm20-100;37029;2141734.684878;120.774021;2;77;0;77
australia-abs-cta;37029;0.000000;37.138391;1;63;0;63
b-ball;37029;-1.818182;4.818182;1;0;0;0
b1c1s1;37029;69995.090000;-0.000000;2;7;0;7
b2c1s1;37029;69710.660000;-0.000000;2;12;0;12
bab1;37029;-228225.182825;27.775000;1;93;0;93
bab2;37029;-327907.020000;270.500000;2;12452;17;12469
bab3;37029;-570680.596583;405.246581;2;28217;40;28257
bab5;37029;-106670.400850;101.900000;2;608;2;610
bab6;37029;-242181.154525;473.597222;2;4879;11;4890
bc;37029;13.915046;0.268421;2;90;0;90
bc1;37029;4.550543;0.028778;2;89;0;89
beasleyC1;37029;102.000000;0.000000;2;3;0;3
beasleyC2;37029;232.000000;0.000000;2;3;0;3
beasleyC3;37029;951.000000;-0.000000;2;4;0;4
beavma;37029;395292.332242;3.472328;2;1;0;1
berlin;37029;1951.000000;0.000000;2;24;0;24
berlin_5_8_0;37029;52.000000;56.222597;3;2;0;2
bg512142;37029;506799.440536;51.840309;3;32;0;32
biella1;37029;3060037.430763;98.993456;1;268;0;268
bienst1;37029;11.724138;4.390524;1;2;0;2
bienst2;37029;11.724138;5.390524;1;2;0;2
binkar10_1;37029;6637.188027;9.084811;1;7;0;7
blend2;37029;7.489992;0.686573;2;0;0;0
bley_xl1;37029;265.196799;287.930058;8;20213;27;20240
bley_xs1;37029;47020884.968217;85.931545;3;83;0;83
bley_xs1noM;37029;52605505.644117;88.493331;2;61;0;61
bley_xs2;37029;30478761.025431;42.229522;12;12;1;13
blp-ar98;37029;9174.508280;11.800505;21;99;28;127
blp-ic97;37029;5423.588709;1.337703;12;66;8;74
blp-ic98;37029;6879.499245;1.657910;4;116;5;121
blp-ir98;37029;3350.173368;3.875758;3;45;1;46
bmocbd3;37029;45423160382.724037;0.000000;2;17740;12;17752
bmoipr2;37029;-46628940.711029;7.840017;1;64;0;64
bnatt350;37029;0.000000;105.289533;17;108;2;110
bnatt400;37029;0.000000;129.427483;17;109;2;111
bppc4-08;37029;51.590000;11.724943;1;20;0;20
bppc6-02;37029;108.340000;11.296538;1;131;0;131
bppc6-06;37029;200.633333;13.595370;1;148;0;148
bppc8-02;37029;486.500000;3.194588;1;1;0;1
bppc8-09;37029;444.436047;4.775100;1;3;0;3
brasil;37029;32311.000000;0.000000;2;29;0;29
brazil3;37029;2.000000;303.450558;1;238;0;238
breastcancer-regularized;37029;105.150036;0.002191;2;8;0;8
bts4-cta;37029;33524.637606;1130.000000;1;493;0;493
buildingenergy;37029;33246.215059;1468.850000;2;16444;4;16448
cap6000;37029;-2446875.000000;0.000000;3;41;0;41
cbs-cta;37029;0.000000;28.754656;1;113;0;113
cdc7-4-3-2;37029;-231.000000;-0.000000;3;36606;6;36612
chromaticindex1024-7;37029;4.000000;16002.682953;2;2479;11;2490
chromaticindex128-5;37029;4.000000;2021.163699;2;148;1;149
chromaticindex256-8;37029;4.000000;4069.477083;2;399;2;401
chromaticindex32-8;37029;4.000000;504.887500;2;18;0;18
chromaticindex512-7;37029;4.000000;8183.527137;2;1041;4;1045
ci-s4;37029;17.644894;42.275628;3;10;0;10
circ10-3;37029;140.000000;209.309855;1;2032;1;2033
cmflsp40-24-10-7;37029;52605868.952858;70.700930;3;360;0;360
cmflsp40-36-2-10;37029;72898024.959478;295.649246;3;798;0;798
cmflsp50-24-10-4;37029;64492612.641644;81.236085;3;407;0;407
cmflsp50-24-8-8;37029;59814378.749021;131.869460;3;373;0;373
cmflsp60-36-2-6;37029;97887903.946142;370.689759;3;1699;0;1699
CMS750_4;37029;250.000000;230.436836;3;65;1;66
co-100;37029;1246685.546783;10.401691;2;343;8;351
cod105;37029;-8.000000;0.000000;3;482;1;483
comp07-2idx;37029;0.000000;114.416667;2;1964;2;1966
comp08-2idx;37029;0.000000;175.467237;3;197;2;199
comp12-2idx;37029;3.000000;261.572878;1;1204;0;1204
comp16-3idx;37029;4.000000;722.263585;1;7208;2;7210
comp21-2idx;37029;0.000000;282.023529;3;467;2;469
control30-3-2-3;37029;-20763026.787568;27.970540;1;3;0;3
core2536-691;37029;789.000000;0.000000;3;760;2;762
core2586-950;37029;1167.000000;-0.000000;3;535;1;536
core4284-1064;37029;1265.000000;0.000000;3;2781;3;2784
core4872-1529;37029;1851.000000;-0.000000;3;1760;3;1763
cost266-UUE;37029;42001606.280000;-0.000000;2;80;0;80
cov1075;37029;35.000000;0.000000;2;5;0;5
cryptanalysiskb128n5obj16;37029;0.000000;5029.990887;106;1164;204;1368
csched007;37029;269.251587;22.185714;1;43;0;43
csched008;37029;171.000000;17.704190;1;11;0;11
csched010;37029;332.422727;20.239899;1;30;0;30
cvrpa-n64k9vrpi;37029;0.000000;99.904419;2;644;4;648
cvrpb-n45k5vrpi;37029;0.000000;107.949911;2;222;1;223
cvrpp-n16k8vrpi;37029;0.000000;41.056694;2;35;0;35
cvrpsimple2i;37029;0.000000;24.056231;2;2;0;2
cvs08r139-94;37029;-16.000000;66.000000;3;12;0;12
cvs16r106-72;37029;-2.000000;71.000000;2;29;0;29
cvs16r128-89;37029;-2.000000;88.000000;2;36;0;36
cvs16r70-62;37029;-0.000000;62.000000;2;28;0;28
cvs16r89-60;37029;-0.000000;60.000000;2;32;0;32
d10200;37029;12425.583005;32.097057;1;40;0;40
d20200;37029;12229.625788;62.339279;1;322;0;322
dale-cta;37029;0.000000;0.004736;1;298;0;298
dano3mip;37029;576.231620;15.297311;1;2164;0;2164
dano3_3;37029;576.231620;1.932181;1;2395;0;2395
dano3_5;37029;576.231620;2.871834;1;2532;0;2532
danoint;37029;62.637280;5.819184;1;20;0;20
dc1c;37029;1754946.863638;140.593306;1;324;1;325
dc1l;37029;211357921.003601;0.000000;3;920;17;937
dcmulti;37029;184917.234283;12.662065;3;3;0;3
decomp1;37029;-120.000000;144.611111;1;45;0;45
decomp2;37029;-160.000000;141.944444;1;51;0;51
dfn-bwin-DBE;37029;797567.400000;-0.000000;2;40;0;40
dfn-gwin-UUM;37029;27467.257235;5.653537;1;2;0;2
dg012142;37029;7485691.825683;37.560751;5;132;0;132
diameterc-mstc-v20a190d5i;37029;291.000000;264.960987;3;77;1;78
diameterc-msts-v40a100d5i;37029;324.000000;357.906639;2;57;0;57
disctom;37029;-5000.000000;51.166667;1;213;0;213
disktom;37029;-5000.000000;51.166667;1;238;0;238
dolom1;37029;6556066.068315;111.218954;1;505;1;506
drayage-100-12;37029;91134.076080;32.686693;1;59;0;59
drayage-100-23;37029;103333.874073;41.554651;1;50;0;50
drayage-25-23;37029;99718.790531;44.055595;1;48;0;48
drayage-25-27;37029;95207.144904;44.816549;1;44;0;44
drayage-25-32;37029;88256.306534;34.610044;1;52;0;52
ds-big;37029;86.820068;30.669231;1;7321;23;7344
ds;37029;57.234565;33.463549;1;1098;6;1104
dws008-01;37029;2954.537147;2.158177;2;51;0;51
dws008-03;37029;3279.903540;8.718992;2;128;1;129
dws012-01;37029;5179.177491;3.971756;2;113;1;114
dws012-02;37029;4797.215617;18.611531;3;227;3;230
dws012-03;37029;5259.387024;14.614141;2;373;4;377
eil33-2;37029;811.278996;3.615630;1;33;0;33
eilA101-2;37029;803.373888;7.408683;1;879;7;886
eilB101;37029;1075.247691;12.807028;1;20;0;20
eilC76-2;37029;725.754458;7.780208;1;271;2;273
ej;37029;1.000000;0.243844;1;0;0;0
elitserienhandball11i;37029;0.000000;866.305983;2;390;1;391
elitserienhandball13i;37029;0.000000;853.141952;2;378;1;379
elitserienhandball14i;37029;0.000000;883.858328;2;376;1;377
elitserienhandball3i;37029;0.000000;887.935483;2;388;1;389
enlight13;37029;1.000000;1.000000;1;0;0;0
enlight15;37029;1.000000;1.000000;1;0;0;0
enlight8;37029;1.000000;1.000000;1;0;0;0
enlight_hard;37029;15.500000;17.000000;1;0;0;0
eva1aprime5x5opt;37029;-497.155823;0.519735;1;313;0;313
eva1aprime6x6opt;37029;-495.398833;1.547904;1;1770;0;1770
ex10;37029;100.000000;98.000000;1;16692;5;16697
ex1010-pi;37029;314.000000;-0.000000;3;496;2;498
ex9;37029;81.000000;75.601201;1;1910;2;1912
exp-1-500-5-5;37029;97666.305541;4.045842;2;2;0;2
f2000;37029;1383.000000;1280.000000;2;3731;0;3731
f2gap201600;37029;76429.862296;1.402159;1;3;0;3
f2gap401600;37029;82274.237434;1.190020;1;4;0;4
f2gap40400;37029;20650.898154;3.253580;1;1;0;1
f2gap801600;37029;86570.120867;5.266841;1;5;0;5
fast0507;37029;207.000000;-0.000000;3;192;4;196
fastxgemm-n2r6s0t2;37029;27.000000;9.000000;1;34;0;34
fastxgemm-n2r7s4t1;37029;27.000000;9.000000;1;35;0;35
fastxgemm-n3r21s3t6;37029;84.000000;27.000000;1;2380;0;2380
fastxgemm-n3r22s4t6;37029;84.000000;27.000000;1;2586;0;2586
fastxgemm-n3r23s5t6;37029;84.000000;27.000000;1;2484;0;2484
fhnw-binpack4-48;37029;0.000000;333.285714;2;141;0;141
fhnw-binpack4-58;37029;0.000000;467.321429;2;127;0;127
fhnw-binpack4-77;37029;0.000000;207.310714;2;122;0;122
fhnw-binschedule0;37029;15642.000000;1053.297818;2;19641;27;19668
fhnw-binschedule2;37029;2273.000000;204.240609;3;478;4;482
fhnw-schedule-paira100;37029;-36.643681;5.149215;2;131;0;131
fhnw-schedule-paira200;37029;-73.826479;8.940825;2;238;3;241
fhnw-schedule-paira400;37029;-146.941079;19.266221;2;1228;13;1241
fhnw-schedule-pairb200;37029;-58.887041;815.939903;3;2064;3;2067
fhnw-schedule-pairb400;37029;-109.169750;2783.836162;3;13426;18;13444
fhnw-sq2;37029;0.000000;12.138998;1;5;0;5
fiball;37029;137.069168;65.011163;1;109;2;111
fiber;37029;897538.360000;12.574421;2;3;0;3
fillomino7x7-0i;37029;0.000000;315.503941;2;59;0;59
fixnet6;37029;4536.000000;0.000000;2;1;0;1
fjspeasy01i;37029;216.000000;1.364719;2;61;0;61
flugpl;37029;1167875.166377;2.785325;1;0;0;0
g200x740;37029;45614.000000;-0.000000;2;4;0;4
g200x740i;37029;44069.000000;-0.000000;2;3;0;3
gasprod1-1;37029;9698.001669;25.784673;6;476;1;477
gasprod1-2;37029;12418.693782;43.662702;18;304;3;307
gasprod1-3;37029;13830.718570;40.837432;64;302;10;312
gasprod2-1;37029;1510393.402354;44.156867;6;1112;1;1113
gasprod2-2;37029;1355909.537507;297.110788;36;1720;13;1733
gen-ip002;37029;-511.036897;0.000000;3;0;0;0
gen-ip016;37029;-9505.628173;1.906914;1;0;0;0
gen-ip021;37029;6642.052620;2.217259;4;0;0;0
gen-ip036;37029;-2162.833562;0.000000;3;0;0;0
gen-ip054;37029;7350.684932;1.502477;8;0;0;0
gen;37029;112555.106141;0.427450;2;1;0;1
genus-g31-8;37029;-27.000000;105.481481;1;1021;1;1022
genus-g61-25;37029;-58.000000;267.593301;1;785;1;786
genus-sym-g31-8;37029;-27.000000;149.527030;1;4201;2;4203
genus-sym-g62-2;37029;-54.000000;222.237614;1;23589;1;23590
genus-sym-grafo5708-48;37029;-27.000000;159.026027;2;1472;0;1472
ger50-17-ptp-pop-3t;37029;3466.323207;45.213645;1;117;0;117
ger50-17-ptp-pop-6t;37029;6804.447088;50.477969;1;92;0;92
ger50-17-trans-dfn-3t;37029;3453.475245;37.741927;1;159;1;160
ger50-17-trans-pop-3t;37029;3456.252922;49.487013;1;155;1;156
ger50_17_trans;37029;6850.628623;48.226110;1;153;1;154
germanrr;37029;47650759.157540;58.297944;3;755;3;758
germany50-DBM;37029;438028.000000;21.150000;1;136;0;136
germany50-UUM;37029;597932.500000;26.450000;1;37;0;37
gesa2-o;37029;25748173.191117;13.380406;2;3;0;3
gesa2;37029;25502855.039680;8.989886;1;6;0;6
gfd-schedulen180f7d50m30k18-16i;37029;21.533333;4297.018832;3;9535;149;9684
gfd-schedulen180f7d50m30k18;37029;1.000000;6044.607327;36;4478;213;4691
gfd-schedulen25f5d20m10k3i;37029;3.000000;24.566406;2;79;0;79
gfd-schedulen55f2d50m30k3i;37029;4.111111;221.771449;2;219;3;222
ghoulomb4-9-10i;37029;9.000000;9.160150;2;54;1;55
glass-sc;37029;23.000000;0.000000;3;117;1;118
glass4;37029;800002400.000000;8.568254;1;0;0;0
gmu-35-40;37029;-2406943.556343;2.300342;1;4;0;4
gmu-35-50;37029;-2608070.315743;3.444186;1;6;0;6
gmut-75-50;37029;-14182312.661731;4.988967;1;551;4;555
gmut-76-40;37029;-14171086.316075;9.054451;1;309;1;310
gmut-76-50;37029;-14173884.188063;4.201959;1;312;3;315
gmut-77-40;37029;-14173396.636852;2.973250;1;349;1;350
go19;37029;96.000000;-0.000000;3;4;0;4
gr4x6;37029;229.050000;-0.000000;2;0;0;0
graph20-20-1rand;37029;-37.000000;43.500000;1;45;0;45
graph20-80-1rand;37029;-110.000000;120.050000;2;1318;2;1320
graph40-20-1rand;37029;-157.000000;173.500000;1;3922;2;3924
graph40-40-1rand;37029;-300.000000;312.000000;1;90231;11;90242
graphdraw-domain;37029;12672.000000;18.742857;1;2;0;2
graphdraw-gemcutter;37029;4310.000000;12.048387;2;2;0;2
graphdraw-grafo2;37029;35762.000000;445.166667;1;821;3;824
graphdraw-mainerd;37029;30496.000000;119.016129;1;81;0;81
graphdraw-opmanager;37029;54717.000000;251.292683;1;397;1;398
gsvm2rl11;37029;35640.343493;0.000000;2;350;0;350
gsvm2rl12;37029;50.000000;-0.000000;2;578;0;578
gsvm2rl3;37029;0.600000;-0.000000;2;3;0;3
gsvm2rl5;37029;10.000000;-0.000000;2;8;0;8
gsvm2rl9;37029;16356.825869;0.000000;2;60;0;60
gt2;37029;21166.000000;4.130952;2;0;0;0
h50x2450;37029;11147.731511;3.696751;1;26;0;26
h80x6320;37029;3700.000000;0.000000;1;42;0;42
h80x6320d;37029;5325.160104;2.515625;1;42;0;42
hanoi5;37029;1931.000000;245.237539;25;310;5;315
haprp;37029;3679667.254486;41.766595;2;4;0;4
harp2;37029;-74325169.345138;5.496152;1;2;0;2
hgms-det;37029;-53793.320679;37.099950;1;199;0;199
hgms30;37029;-53327.995245;51.804834;1;7342;0;7342
hgms62;37029;-53394.446147;54.735370;1;14172;0;14172
hypothyroid-k1;37029;-2846.896104;38.365286;3;7112;7;7119
ic97_potential;37029;4058.000000;55.050000;2;3;0;3
ic97_tension;37029;3993.000000;15.366667;2;2;0;2
icir97_potential;37029;6619.000000;172.384181;2;38;0;38
icir97_tension;37029;6323.000000;102.600000;2;2;0;2
iis-100-0-cov;37029;41.000000;0.000000;3;92;0;92
iis-bupa-cov;37029;49.000000;-0.000000;3;163;0;163
iis-glass-cov;37029;28.000000;0.000000;3;113;1;114
iis-hc-cov;37029;22.000000;0.000000;3;157;2;159
iis-pima-cov;37029;41.000000;-0.000000;3;191;1;192
irp;37029;12123.530222;6.000000;1;77;1;78
istanbul-no-cutoff;37029;62.541409;3.968407;1;272;0;272
ivu06-big;37029;135.427718;95.799872;1;52543;171;52714
ivu06;37029;135.901353;96.981489;1;14240;58;14298
ivu52;37029;480.250438;81.910351;1;6202;14;6216
ivu59;37029;884.456993;122.834601;1;212340;217;212557
janos-us-DDM;37029;1488134.750000;22.375000;1;8;0;8
k16x240;37029;11359.000000;0.000000;2;1;0;1
k16x240b;37029;12874.000000;0.000000;2;0;0;0
k1mushroom;37029;-3747.840298;42.576586;3;20802;23;20825
k1mushroomi;37029;-4165.061224;64.102041;1;15032;3;15035
khb05250;37029;126785464.000000;0.000000;2;1;0;1
l2p12;37029;2.000000;831.449119;3;222;1;223
l2p1i;37029;1.000000;607.419608;2;880;22;902
l2p2i;37029;1.000000;874.857828;2;140;1;141
lectsched-1-obj;37029;36.000000;28.046924;4;208;3;211
lectsched-1;37029;0.000000;6.882322;2;173;1;174
lectsched-2;37029;0.000000;29.221196;3;77;1;78
lectsched-3;37029;0.000000;4.358796;9;174;4;178
lectsched-4-obj;37029;3.000000;14.190535;14;52;2;54
lectsched-5-obj;37029;15.000000;44.276539;5;168;2;170
leo1;37029;530605779.573215;2.950107;3;67;1;68
leo2;37029;572818097.713015;1.549961;3;101;2;103
liu;37029;346.000000;11.229183;2;4;0;4
loopha13;37029;6.279000;1.132999;2;180;0;180
lotsize;37029;1335747.052789;7.405615;2;6;0;6
lr1dr02vc05v8a-t360;37029;120707.344638;169.266715;1;840;0;840
lr1dr04vc05v17a-t360;37029;247150.518188;322.854834;1;1778;1;1779
lr1dr12vc10v70b-t360;37029;983958.597196;1051.434951;1;43842;9;43851
lr2-22dr3-333vc4v17a-t60;37029;-72770.836006;244.127587;2;37331;8;37339
lrn;37029;44373752.713965;53.546052;2;380;0;380
m100n500k4r1;37029;-17.000000;-0.000000;3;5;0;5
macrophage;37029;35.000000;209.000000;1;4;0;4
mad;37029;0.000000;4.366204;1;1;0;1
manna81;37029;-11868.000000;0.000000;3;41;0;41
map06;37029;-406.181173;7.868443;1;1048;0;1048
map10;37029;-602.176181;11.248146;1;929;0;929
map14;37029;-778.549324;11.962355;1;1023;0;1023
map14860-20;37029;-998.836419;10.400693;1;1309;0;1309
map16715-04;37029;-296.267898;4.997036;1;1099;0;1099
map18;37029;-932.782685;11.173489;1;1374;0;1374
map20;37029;-998.836419;10.400693;1;1394;0;1394
mappingmesh3x3mpeg2i;37029;10000.000000;161.127209;2;27;0;27
mario-t-hard5i;37029;-4482.000000;235.149319;1;177;2;179
markshare1;37029;230.000000;-0.000000;2;0;0;0
markshare2;37029;454.000000;0.000000;2;0;0;0
markshare_4_0;37029;226.000000;0.000000;2;0;0;0
markshare_5_0;37029;337.000000;0.000000;2;0;0;0
mas74;37029;10482.795280;3.103514;1;1;0;1
mas76;37029;38893.903641;2.555097;1;1;0;1
maxgasflow;37029;-53620694.316699;233.171088;2;59;0;59
mc11;37029;13520.000000;-0.000000;2;30;0;30
mc7;37029;5797.000000;-0.000000;2;33;0;33
mc8;37029;1944.000000;-0.000000;2;32;0;32
mcsched;37029;474351.816438;29.021488;2;167;0;167
methanosarcina;37029;0.000000;282.500000;1;58;0;58
mik-250-1-100-1;37029;-0.000000;0.000000;2;2;0;2
mik-250-20-75-1;37029;0.000000;0.000000;2;3;0;3
mik-250-20-75-2;37029;-0.000000;-0.000000;2;3;0;3
mik-250-20-75-3;37029;-0.000000;-0.000000;2;3;0;3
mik-250-20-75-4;37029;-0.000000;-0.000000;2;3;0;3
mik-250-20-75-5;37029;0.000000;-0.000000;2;3;0;3
milo-v12-6-r1-58-1;37029;422507.582835;145.714423;2;154;0;154
milo-v12-6-r1-75-1;37029;684446.509887;174.270141;2;185;0;185
milo-v12-6-r2-40-1;37029;213638.744473;103.889654;2;85;0;85
milo-v13-4-3d-3-0;37029;23373.122645;0.739975;1;20;0;20
milo-v13-4-3d-4-0;37029;34049.245605;1.277727;1;33;0;33
mine-166-5;37029;-552883467.060796;36.684884;5;137;0;137
mine-90-10;37029;-827656854.061004;55.076435;1;92;0;92
mining;37029;-885911894.603839;8594.317279;65;73176;1296;74472
minutedispatchstrategy;37029;3582.138213;101.664381;1441;1971;633;2604
misc07;37029;1415.000000;8.000000;1;2;0;2
mitre;37029;114908.998992;168.716846;1;62;0;62
mkc;37029;-298.990000;-0.000000;3;32;0;32
mkc1;37029;-550.278772;6.529051;3;35;0;35
mod010;37029;6532.083333;15.166667;1;13;0;13
modglob;37029;20786787.016883;-0.000000;2;1;0;1
moj-mining;37029;-1520532907.350179;566.626558;2;46345;0;46345
momentum1;37029;121860.460323;47.487111;2;144;0;144
momentum2;37029;12884.172158;84.534262;3;508;1;509
mrcpspj30-15-5i;37029;23.000000;77.119901;2;53;0;53
mrcpspj30-17-10i;37029;25.000000;225.155906;34;106;13;119
mrcpspj30-53-3i;37029;30.000000;87.673073;2;47;0;47
msc98-ip;37029;19530897.712302;353.788784;2;746;1;747
mspp16;37029;341.000000;3.000000;1;24536;134;24670
mspsphard01i;37029;69.000000;44.768654;3;59;1;60
mspsphard03i;37029;73.000000;89.470874;5;95;2;97
mtest4ma;37029;60342.000000;0.000000;2;2;0;2
mushroom-best;37029;0.079076;0.007000;3;221;3;224
mzzv11;37029;-22076.000000;186.202623;2;248;1;249
mzzv42z;37029;-20490.000000;179.192264;2;281;1;282
n13-3;37029;4810470.000000;0.000000;2;3;0;3
n15-3;37029;71710891.000000;0.000000;2;4869;0;4869
n2seq36f;37029;71600.000000;-0.000000;3;32;0;32
n2seq36q;37029;101037.600000;28.840000;3;139;3;142
n3-3;37029;23704230.000000;0.000000;2;130;0;130
n3700;37029;1342560.000000;0.000000;2;24;0;24
n3705;37029;1342540.000000;0.000000;2;26;0;26
n3707;37029;1301218.000000;0.000000;2;27;0;27
n3709;37029;1324904.000000;-0.000000;2;24;0;24
n370a;37029;1353042.000000;-0.000000;2;27;0;27
n370b;37029;1373791.000000;-0.000000;2;25;0;25
n3div36;37029;314000.000000;6.227888;3;161;4;165
n3seq24;37029;198664.580534;43.960251;3;2337;41;2378
n4-3;37029;12003175.000000;-0.000000;2;61;0;61
n5-3;37029;10502425.000000;-0.000000;2;14;0;14
n6-3;37029;10807500.000000;0.000000;2;46;0;46
n7-3;37029;8409710.000000;0.000000;2;38;0;38
n9-3;37029;20705025.000000;-0.000000;2;137;0;137
nag;37029;465.000000;10.908434;4;47;0;47
neos-1061020;37029;-145860.370608;501.054054;1;803;0;803
neos-1067731;37029;669053.000000;87.000000;1;569;0;569
neos-1109824;37029;278.000000;22.000000;1;39;0;39
neos-1112782;37029;22000000110147.347656;0.000000;2;24;0;24
neos-1112787;37029;19500000125389.667969;0.000000;2;23;0;23
neos-1122047;37029;162.000000;0.000000;2;113;0;113
neos-1171448;37029;-309.000000;5.777778;2;116;0;116
neos-1171692;37029;-273.000000;4.936782;2;46;0;46
neos-1171737;37029;-195.000000;9.875000;2;51;0;51
neos-1225589;37029;5000000000.000000;-0.000000;2;1;0;1
neos-1311124;37029;-182.000000;5.250000;2;4;0;4
neos-1324574;37029;36.000000;135.000000;2;35;0;35
neos-1330346;37029;34.000000;90.268408;2;62;0;62
neos-1337307;37029;-201272.000000;272.493985;2;47;0;47
neos-1354092;37029;46.000000;235.398385;2;1077;2;1079
neos-1367061;37029;31320456.264497;6.250000;2;1242;1;1243
neos-1396125;37029;3000.046554;10.228463;2;8;0;8
neos-1420546;37029;22124.400000;103.140678;1;402;0;402
neos-1420790;37029;2942.750002;75.132359;1;57;0;57
neos-1423785;37029;-1773.639422;144.183541;2;350;0;350
neos-1425699;37029;3175561447.505317;0.344988;1;0;0;0
neos-1426635;37029;-178.000000;6.235119;2;2;0;2
neos-1426662;37029;-52.000000;24.768519;2;4;0;4
neos-1429212;37029;2425.386455;328.355033;1;4867;9;4876
neos-1430701;37029;-78.000000;5.278895;2;2;0;2
neos-1436709;37029;-129.000000;5.000000;2;4;0;4
neos-1440225;37029;36.000000;34.173132;1;69;0;69
neos-1440460;37029;-180.000000;5.527778;2;3;0;3
neos-1442119;37029;-182.000000;7.291667;2;4;0;4
neos-1442657;37029;-156.000000;6.083333;2;3;0;3
neos-1445532;37029;-14382.000000;4.666667;2;27;0;27
neos-1445738;37029;-18525.765543;192.856918;1;1117;0;1117
neos-1445743;37029;-18902.810023;198.050465;1;1115;0;1115
neos-1445765;37029;-18811.492536;210.050240;1;1112;0;1112
neos-1456979;37029;154.000000;27.901173;1;41;0;41
neos-1516309;37029;34769.833333;9.166667;2;31;0;31
neos-1582420;37029;88.469527;56.693409;5;39;0;39
neos-1593097;37029;19581.000000;35.532718;1;42;0;42
neos-1599274;37029;31644.742857;8.000000;2;32;0;32
neos-1601936;37029;1.000000;152.757983;1;822;0;822
neos-1603965;37029;619257281.729079;159.275183;3;2192;1;2193
neos-1605061;37029;6.150735;154.102548;1;2396;0;2396
neos-1605075;37029;3.214461;178.628105;1;1950;0;1950
neos-1616732;37029;174.000000;-0.000000;3;64;0;64
neos-1620770;37029;22.000000;35.000000;2;205;0;205
neos-2294525-abba;37029;251.550909;2.782932;1;97;0;97
neos-2328163-agri;37029;27254.625000;62.348214;1;123;0;123
neos-2624317-amur;37029;0.000000;22.711257;1;3;0;3
neos-2629914-sudost;37029;39622.000000;15.333333;1;202;0;202
neos-2652786-brda;37029;0.000000;15.533521;2;1;0;1
neos-2657525-crna;37029;0.000000;18.351928;2;1;0;1
neos-2669500-cust;37029;2221.900000;100.250838;1;465;5;470
neos-2746589-doon;37029;1985.939796;54.551734;1;207;2;209
neos-2974461-ibar;37029;472952396.770997;3364.000000;2;177420;34;177454
neos-2978193-inde;37029;-2.418518;7.400000;1;58;0;58
neos-2978205-isar;37029;-12.415307;28.800000;1;190;0;190
neos-2987202-jeir;37029;-1847551552.236609;1035.632796;2;63488;1;63489
neos-2987310-joes;37029;-610797465.676975;19.875000;2;847;0;847
neos-2991472-kalu;37029;138.000000;18.557396;2;3162;87;3249
neos-3004026-krka;37029;0.000000;832.000000;1;46;0;46
neos-3009394-lami;37029;0.642857;216.628571;1;3;0;3
neos-3024952-loue;37029;25442.000000;116.550000;5;226;0;226
neos-3025225-shelon;37029;0.077135;318.031391;1;86452;22;86474
neos-3046601-motu;37029;185.000000;0.023300;2;0;0;0
neos-3046615-murg;37029;192.000000;0.024900;2;0;0;0
neos-3048764-nadi;37029;-3883988306.366695;0.000000;1;34;0;34
neos-3065804-namu;37029;0.000000;0.000000;1;218;0;218
neos-3068746-nene;37029;77427529.530929;51.698455;2;140;0;140
neos-3072252-nete;37029;10593526.000000;1.938794;2;1;0;1
neos-3075395-nile;37029;1127152.765198;9.064729;1;68;0;68
neos-3083784-nive;37029;0.000000;0.395487;1;6;0;6
neos-3083819-nubu;37029;6290575.552807;5.598385;1;38;0;38
neos-3116779-oban;37029;0.000000;0.000000;1;21;0;21
neos-3118745-obra;37029;291.000000;-0.000000;3;4;0;4
neos-3148108-pahi;37029;0.000000;0.000000;1;81;0;81
neos-3209462-rhin;37029;0.000000;47.352227;2;4562;1;4563
neos-3209519-ruhr;37029;332.850000;25.096416;1;51;0;51
neos-3214367-sovi;37029;87807.062267;86.266322;1;1460;0;1460
neos-3216931-puriri;37029;58817.360975;51.659853;1;1148;0;1148
neos-3226448-wkra;37029;0.000000;512.043709;1;754;0;754
neos-3237086-abava;37029;0.000000;56.000000;1;198;2;200
neos-3322547-alsek;37029;616.000000;115.178534;2;10390;67;10457
neos-3352863-ancoa;37029;43800.000000;-0.000000;3;893;18;911
neos-3354841-apure;37029;48560.000000;3.800000;1;2252;25;2277
neos-3355120-tarago;37029;-19761147.469026;128.754971;1;926;2;928
neos-3355323-arnon;37029;0.000000;33.818182;4;83;4;87
neos-3372571-onahau;37029;0.576990;8.695953;2;1243;0;1243
neos-3373491-avoca;37029;21687686014.015354;20.812587;1;10;0;10
neos-3381206-awhea;37029;432.000000;61.334767;2;5;0;5
neos-3402294-bobin;37029;0.000000;50.584407;1;228;2;230
neos-3426085-ticino;37029;235.000000;41.787470;3;33;0;33
neos-3426132-dieze;37029;427.000000;103.670666;2;53;0;53
neos-3437289-erdre;37029;0.000000;0.000000;1;76;1;77
neos-3530903-gauja;37029;170.000000;33.253136;3;5;0;5
neos-3530905-gaula;37029;153.000000;29.042208;2;4;0;4
neos-3555904-turama;37029;-37.664423;1768.886014;4;5519;6;5525
neos-3572885-glina;37029;0.000000;0.000000;1;76;1;77
neos-3581454-haast;37029;1969.000000;47.338710;1;80;0;80
neos-3592146-hawea;37029;7345804.855333;13.281253;1;42;0;42
neos-3594536-henty;37029;383310.000000;1311.000000;1;67;1;68
neos-3603137-hoteo;37029;0.000000;38.166667;3;66;1;67
neos-3610040-iskar;37029;37.165417;2.262083;2;2;0;2
neos-3610051-istra;37029;48.227558;5.054237;2;4;0;4
neos-3610173-itata;37029;147.441250;3.692500;2;4;0;4
neos-3611447-jijia;37029;116.645382;2.294795;2;2;0;2
neos-3611689-kaihu;37029;138.382063;1.574126;2;2;0;2
neos-3615091-sutlej;37029;-1506391.117177;161.684320;1;1716;8;1724
neos-3627168-kasai;37029;1028641.180000;2.678667;2;3;0;3
neos-3634244-kauru;37029;0.000000;152.720000;1;3767;4;3771
neos-3636886-kereu;37029;1114.701601;0.001506;2;55;0;55
neos-3660371-kurow;37029;286.534383;18.104379;1;17;0;17
neos-3661949-lesse;37029;689000000.000000;0.000000;1;2;0;2
neos-3665875-lesum;37029;248.325000;40.526828;2;72;0;72
neos-3682128-sandon;37029;30098104.111687;108.126984;2;82;0;82
neos-3691541-lonja;37029;-0.061575;9.639780;1;58;0;58
neos-3695882-vesdre;37029;-145935.214286;38.967891;1;281;1;282
neos-3696678-lyvia;37029;83.750000;63.000000;1;5;0;5
neos-3699377-maori;37029;135877.224265;84.275975;2;97;0;97
neos-3703351-marne;37029;317056.210386;73.309688;2;54;0;54
neos-3740487-motru;37029;152.145486;76.975427;2;38734;63;38797
neos-3754480-nidda;37029;-1216923.270104;12.186832;1;2;0;2
neos-3755335-nizao;37029;50.030157;82.516978;2;525;1;526
neos-3759587-noosa;37029;48.334468;4.320000;3;337;1;338
neos-3761878-oglio;37029;422769.022545;68.617519;2;41;0;41
neos-3762025-ognon;37029;603955.746492;51.755251;2;38;0;38
neos-4165869-wannon;37029;285.150608;103.410202;2;625;1;626
neos-4230265-orari;37029;38515515.684909;56.957317;3;2791;1;2792
neos-4260495-otere;37029;3462.928116;161.718352;3;488;9;497
neos-4264598-oueme;37029;4719412304.625630;65.571331;2;2003;0;2003
neos-4285819-pedja;37029;34.451960;101.159938;2;287944;63;288007
neos-4290317-perth;37029;3613303.634755;0.000000;2;1698;0;1698
neos-4295773-pissa;37029;0.000000;1644.289474;1;5235;4;5239
neos-4300652-rahue;37029;0.000000;32.333333;1;773;1;774
neos-4306827-ravan;37029;-26673.307580;191.390311;2;339;4;343
neos-4321076-ruwer;37029;1880.558333;39.333333;1;19490;1;19491
neos-4322846-ryton;37029;0.419848;27.932085;1;674;6;680
neos-4332801-seret;37029;233683.594384;171.178174;3;342;7;349
neos-4332810-sesia;37029;-23062.998566;161.274117;3;296;6;302
neos-4333464-siret;37029;24.688318;0.121324;2;10;0;10
neos-4333596-skien;37029;-14653654.846569;0.746303;1;3;0;3
neos-4335793-snake;37029;0.123684;141.753072;2;1347;1;1348
neos-4338804-snowy;37029;1447.000000;17.873600;3;4;0;4
neos-4343293-stony;37029;52.758728;0.200000;2;57;0;57
neos-4355351-swalm;37029;33.854869;0.094819;2;161;3;164
neos-4358725-tagus;37029;1889548.577948;203.435939;2;686;0;686
neos-4359986-taipa;37029;0.395578;39.118149;1;1067;1;1068
neos-4360552-sangro;37029;-29.500000;572.303976;1;8993;1;8994
neos-4387871-tavua;37029;36.445048;0.200000;2;51;0;51
neos-4391920-timok;37029;0.000378;34.957374;1;5911;5;5916
neos-4393408-tinui;37029;340.267489;0.200000;2;43;0;43
neos-4408804-prosna;37029;914.483516;71.708791;1;3492;1;3493
neos-4409277-trave;37029;0.000000;350.162065;1;1779;1;1780
neos-4413714-turia;37029;43.474651;369.948540;1;1935;10;1945
neos-4532248-waihi;37029;0.370420;32.577719;1;4387;4;4391
neos-4533806-waima;37029;3063.318841;49.500000;1;939;4;943
neos-4545615-waita;37029;3606.594190;54.131913;1;18761;41;18802
neos-4555749-wards;37029;3026.812121;34.958139;1;865;4;869
neos-4562542-watut;37029;3743.304348;42.464103;1;2706;8;2714
neos-4647027-thurso;37029;26911.641616;130.575703;1;2306;0;2306
neos-4647030-tutaki;37029;26911.641616;131.360812;1;2761;0;2761
neos-4647032-veleka;37029;26587.908699;174.943874;1;3449;0;3449
neos-4650160-yukon;37029;-22633.302692;150.257047;1;5;0;5
neos-4722843-widden;37029;63671.455263;748.515195;3;382;7;389
neos-4724674-aorere;37029;3955.706101;88.928956;3;365;6;371
neos-4736745-arroux;37029;262263446.114579;4.100609;2;32;0;32
neos-4738912-atrato;37029;323678468.688703;3.843750;2;28;0;28
neos-4754521-awarau;37029;0.000000;0.000000;1;1098;6;1104
neos-4760493-puerua;37029;1908.243695;237.071976;1;32765;2;32767
neos-476283;37029;406.244708;13.663873;1;5707;0;5707
neos-4763324-toguru;37029;1120.986062;232.945926;1;32758;3;32761
neos-4797081-pakoka;37029;0.000000;995.738455;1;6917;2;6919
neos-4805882-barwon;37029;22058.983698;108.041076;3;194;1;195
neos-480878;37029;515.138796;4.583278;2;17;0;17
neos-4954274-beardy;37029;18659.208282;287.749893;2;914;2;916
neos-4954672-berkel;37029;3491016.775148;2.808176;2;2;0;2
neos-4966258-blicks;37029;366.090909;32.634154;2;1160;2;1162
neos-4971100-bodrog;37029;0.000000;0.000000;1;47;0;47
neos-4972437-bojana;37029;357.086296;28.807479;2;9050;2;9052
neos-4972461-bolong;37029;466.511858;36.737112;2;5951;2;5953
neos-4976951-bunnoo;37029;377.416466;26.273303;2;5048;2;5050
neos-4984115-canche;37029;-9947088.084138;0.363560;1;12;0;12
neos-498623;37029;16.283333;44.828704;1;89;0;89
neos-5013590-toitoi;37029;1064.447092;169.000000;1;12548;1;12549
neos-5018451-chiese;37029;-148612315.605332;10.652915;1;1383;0;1383
neos-503737;37029;50.000000;47.918146;1;31;0;31
neos-5041822-cockle;37029;5701464.927099;174.422554;3;875;3;878
neos-5044663-wairoa;37029;4653100.000000;565.703885;1;17061;2;17063
neos-5045105-creuse;37029;19.066672;17.344408;1;61;0;61
neos-5049753-cuanza;37029;464.000000;46.400000;1;2006;2;2008
neos-5051588-culgoa;37029;128.750000;30.632366;1;91;0;91
neos-5052403-cygnet;37029;214.868916;84.825356;6;36955;120;37075
neos-506422;37029;0.000000;7.000000;1;149;0;149
neos-506428;37029;145945.000000;96.000000;1;1054;5;1059
neos-5075914-elvire;37029;326.576324;56.255415;2;48;0;48
neos-5076235-embley;37029;1930.000000;0.112088;2;457;0;457
neos-5078479-escaut;37029;7438.416728;38.551929;2;105;0;105
neos-5079731-flyers;37029;2004.000000;1.153846;2;485;0;485
neos-5083528-gimone;37029;0.000000;17.250000;1;219;3;222
neos-5093327-huahum;37029;3934.000000;1.858333;2;529;0;529
neos-5100895-inster;37029;2084.000000;3.428571;2;350;0;350
neos-5102383-irwell;37029;1740.000000;2.593407;2;516;0;516
neos-5104907-jarama;37029;648.590198;45.615037;2;7395;2;7397
neos-5106984-jizera;37029;721.000000;2.214286;2;2921;3;2924
neos-5107597-kakapo;37029;0.000000;0.591250;2;33;0;33
neos-5108386-kalang;37029;621.655661;44.513210;2;18327;5;18332
neos-5114902-kasavu;37029;518.000000;88.000000;2;8171;9;8180
neos-5115478-kaveri;37029;0.000000;0.529375;2;29;0;29
neos-5116085-kenana;37029;452.000000;75.333333;1;5341;3;5344
neos-5118834-korana;37029;583.521384;86.843852;2;12448;4;12452
neos-5118851-kowhai;37029;1134.000000;4.250000;2;3678;5;3683
neos-5123665-limmat;37029;654.150497;45.837225;2;19687;5;19692
neos-5125849-lopori;37029;0.000000;5.984639;1;38;0;38
neos-5129192-manaia;37029;0.000000;10.000000;1;2962;11;2973
neos-5138690-middle;37029;609.154239;78.962029;2;23258;4;23262
neos-5140963-mincio;37029;8877.000000;2.142857;1;1;0;1
neos-5149806-wieprz;37029;45.000000;8.083000;4;385;12;397
neos-5151569-mologa;37029;686060547.750363;27.742842;2;2930;3;2933
neos-5178119-nalagi;37029;8.569859;23.987927;2;134;1;135
neos-5182409-nasivi;37029;0.000000;19.680679;1;8;0;8
neos-5188808-nattai;37029;0.000000;12.794689;1;468;0;468
neos-5189128-totara;37029;330131.390743;21.863581;1;992;2;994
neos-5192052-neckar;37029;-11980000.000000;0.400000;2;0;0;0
neos-5193246-nerang;37029;0.000000;407.058098;1;410;0;410
neos-5195221-niemur;37029;0.000000;340.047019;1;338;0;338
neos-5196530-nuhaka;37029;0.000000;437.613062;1;272;0;272
neos-520729;37029;-1389625.000000;9.185238;1;527;0;527
neos-5221106-oparau;37029;0.000000;33.949758;1;586;1;587
neos-525149;37029;60.000000;40.416667;1;34;0;34
neos-5260764-orauea;37029;58748.022532;8.725559;1;80;0;80
neos-5261882-treska;37029;26047.998000;6.157765;1;7;0;7
neos-5266653-tugela;37029;21659.678723;20.155553;1;138;1;139
neos-555001;37029;962625.000000;32.414286;1;6;0;6
neos-555343;37029;1346700.000000;157.193056;4;9;0;9
neos-555424;37029;1286800.000000;144.027778;1;60;0;60
neos-555884;37029;1112400.000000;165.150000;1;40;0;40
neos-565672;37029;55015.268433;57.351362;4;14850;19;14869
neos-574665;37029;5932913.752734;8.390264;3;5;0;5
neos-578379;37029;0.000000;99.503183;1;1773;1;1774
neos-585192;37029;384.328979;0.433130;2;12;0;12
neos-585467;37029;347.224531;0.316538;2;8;0;8
neos-595904;37029;61213.471080;16.893904;2;78;0;78
neos-619167;37029;1.481241;35.984608;1;138;0;138
neos-631517;37029;6739789.880207;54.765396;2;9;0;9
neos-631710;37029;286.000000;225.464535;2;969;17;986
neos-633273;37029;6996841097.997801;0.000000;1;161;0;161
neos-662469;37029;184342.980720;94.063832;1;432;1;433
neos-686190;37029;5134.813830;17.515957;1;35;0;35
neos-691058;37029;263.400000;89.722030;1;145;0;145
neos-693347;37029;234.000000;78.650471;1;674;0;674
neos-738098;37029;-1099.000000;183.414545;1;244;0;244
neos-777800;37029;-80.000000;75.998740;1;57;0;57
neos-780889;37029;3421500.000000;0.000000;1;340;4;344
neos-787933;37029;30.000000;0.000000;1;1;0;1
neos-799711;37029;-11228065.153797;82.404201;1;741;0;741
neos-799716;37029;4932670.661692;20.807498;1;50;0;50
neos-807639;37029;332.924117;12.512286;1;6;0;6
neos-820879;37029;24874.267857;63.030000;1;77;0;77
neos-824661;37029;55.000000;94.965217;2;234;1;235
neos-824695;37029;43.000000;61.571429;2;90;0;90
neos-826224;37029;124.000000;43.333333;2;194;2;196
neos-826650;37029;32.000000;154.916667;2;40;0;40
neos-826694;37029;72.000000;221.851190;2;121;1;122
neos-826812;37029;69.011000;175.561360;3;120;1;121
neos-826841;37029;32.008200;127.466667;2;38;0;38
neos-827015;37029;2.098071;332.649497;1;1621;3;1624
neos-827175;37029;115.001520;111.833333;2;155;2;157
neos-829552;37029;2.098071;248.920991;1;1677;1;1678
neos-831188;37029;1.767720;87.466667;1;53;0;53
neos-847302;37029;0.000000;50.238405;1;46;0;46
neos-848198;37029;168977.000000;-0.000000;2;146;0;146
neos-848589;37029;0.000000;1.000000;1;1207;1;1208
neos-849702;37029;0.000000;84.820647;1;19;0;19
neos-850681;37029;2087.000000;59.090597;1;117;0;117
neos-860300;37029;2035.362225;9.000000;1;40;0;40
neos-872648;37029;52.571637;0.000000;2;1052;8;1060
neos-873061;37029;135.208828;0.000000;2;1399;8;1407
neos-876808;37029;169615.062608;275.400000;2;2897;2;2899
neos-885086;37029;-243.000000;18.235808;2;207;0;207
neos-885524;37029;12397.479000;5.525486;3;64;2;66
neos-911880;37029;23.260000;14.681422;1;2;0;2
neos-911970;37029;23.260000;20.048919;1;2;0;2
neos-913984;37029;1000.000000;36.385148;1;154;3;157
neos-914441;37029;5660364.283770;87.286515;1;2155;0;2155
neos-916792;37029;26.283217;17.068306;2;129;0;129
neos-932721;37029;513000.000000;-0.000000;2;52;0;52
neos-932816;37029;513000.000000;0.000000;2;129;0;129
neos-933562;37029;0.000000;82.687196;1;29;0;29
neos-933638;37029;452018.000000;-0.000000;2;141;1;142
neos-933966;37029;412038.000000;-0.000000;2;120;1;121
neos-934278;37029;444012.000000;0.000000;2;294;1;295
neos-935234;37029;436011.000000;0.000000;2;296;1;297
neos-935627;37029;23070.000000;0.000000;2;333;1;334
neos-935769;37029;23610.000000;-0.000000;2;324;1;325
neos-937511;37029;52640.000000;-0.000000;2;471;1;472
neos-937815;37029;54650.000000;0.000000;2;479;1;480
neos-941262;37029;51923.000000;-0.000000;2;351;1;352
neos-941313;37029;9361.000000;252.116021;1;489;6;495
neos-942830;37029;12.000000;62.559527;2;32;0;32
neos-948126;37029;52602.000000;-0.000000;2;374;1;375
neos-948346;37029;-182.737034;18.375561;16;490;65;555
neos-950242;37029;2.000000;42.000000;2;107;1;108
neos-953928;37029;-8.906667;12.942467;4;152;5;157
neos-954925;37029;-147.787389;45.557191;4;356;16;372
neos-956971;37029;-104.788318;34.217227;5;548;20;568
neos-957143;37029;-185.847699;34.060881;5;573;18;591
neos-957323;37029;-218.785116;18.500000;3;342;13;355
neos-957389;37029;1.500000;15.470175;1;90;1;91
neos-960392;37029;-238.000000;301.558442;1;292;3;295
neos-983171;37029;52403.000000;0.000000;2;422;1;423
neos-984165;37029;51812.000000;0.000000;2;413;1;414
neos13;37029;-126.178378;42.587671;3;180;0;180
neos15;37029;143201.242910;0.000000;2;1;0;1
neos16;37029;429.000000;12.571429;3;4;0;4
neos17;37029;0.222688;0.000000;2;7;0;7
neos18;37029;12.000000;42.166667;6;83;0;83
neos2;37029;-4407.097239;5.158588;1;5;0;5
neos22;37029;792540.000000;11.064286;2;35;0;35
neos5;37029;17.250000;0.000000;2;1;0;1
neos6;37029;114.038055;32.275044;6;320;8;328
neos8;37029;-3309.500000;20.750000;3;58;0;58
neos808444;37029;0.000000;193.039827;1;283;1;284
neos9;37029;780.000000;44.250000;1;364;0;364
net12;37029;47.514236;175.164931;3;981;1;982
netdiversion;37029;454.800000;765.000000;2;7237;10;7247
newdano;37029;11.724138;8.447296;1;2;0;2
nexp-150-20-1-5;37029;74.000000;-0.000000;3;36;0;36
nexp-150-20-8-5;37029;560.000000;-0.000000;3;66;1;67
nexp-50-20-1-1;37029;35.000000;-0.000000;2;0;0;0
nexp-50-20-4-2;37029;120.000000;0.000000;2;2;0;2
nh97_potential;37029;1462.000000;73.200000;2;5;0;5
nh97_tension;37029;1429.000000;76.466667;2;1;0;1
nj1;37029;0.000000;607.000000;1;447;1;448
nj2;37029;0.000000;607.000000;1;612;1;613
nj3;37029;0.000000;607.000000;1;1649;1;1650
nobel-eu-DBE;37029;7456550.000000;0.800000;2;69;0;69
noswot;37029;-39.920111;4.557455;3;1;0;1
ns1111636;37029;96.250000;17.588542;1;260;1;261
ns1116954;37029;0.000000;154.227320;1;680;1;681
ns1208400;37029;0.000000;98.625000;1;34;0;34
ns1430538;37029;73.621609;10.760231;1;403;0;403
ns1456591;37029;361.939022;19.000000;1;113;0;113
ns1606230;37029;13.225000;184.269160;1;1633;0;1633
ns1631475;37029;94800.000000;643.196596;2;1271;2;1273
ns1679495;37029;3355407.151677;106.229642;2;47168;9;47177
ns1685374;37029;-51.800913;96.218654;1;2395;1;2396
ns1688347;37029;2.259259;26.784316;1;340;0;340
ns1690781;37029;-1022.227789;60.056795;2;93;0;93
ns1696083;37029;2.038462;48.811865;1;507;1;508
ns1758913;37029;-1473.311978;85.635340;1;8228;4;8232
ns1760995;37029;-1349.487943;142.000000;1;16230;8;16238
ns1778858;37029;-22635740.000000;227.465047;2;318;0;318
ns1828997;37029;0.000000;75.000000;1;1902;1;1903
ns1830653;37029;7083.000000;56.889599;1;96;0;96
ns1849932;37029;546.000000;5.425770;1;1045;6;1051
ns1853823;37029;1172000.000000;1345.731857;2;43000;22;43022
ns1854840;37029;1664000.000000;1124.615817;2;8639;15;8654
ns1856153;37029;0.000000;203.023072;2;205;1;206
ns1904248;37029;0.000000;476.666667;3;2473;10;2483
ns1905797;37029;11.750980;32.426504;1;214;1;215
ns1905800;37029;6.436600;26.487503;1;45;0;45
ns1952667;37029;0.000000;9.316422;1;243;1;244
ns2017839;37029;77026841466348.468750;1.620352;2;4668;0;4668
ns2034125;37029;24740.000000;387.512494;2;2740;0;2740
ns2071214;37029;0.000000;42.769522;1;85;0;85
ns2081729;37029;4.600000;0.185500;2;3;0;3
ns2122698;37029;62785.622771;196.156523;1;395;1;396
ns2124243;37029;53998.333333;192.722222;1;248;1;249
ns2137859;37029;24629.000000;56.954851;1;103;0;103
ns4-pr3;37029;711323.000000;0.000000;2;125;0;125
ns4-pr6;37029;395464.500000;0.000000;2;59;0;59
ns4-pr9;37029;481275.000000;0.000000;2;72;0;72
ns894236;37029;18.000000;109.321441;2;218;0;218
ns894244;37029;16.000000;173.406937;2;528;1;529
ns894786;37029;14.000000;98.226662;2;496;2;498
ns894788;37029;7.000000;55.133280;2;77;0;77
ns903616;37029;22.000000;171.407176;2;562;1;563
nsa;37029;91.855632;7.418401;2;7;0;7
nsr8k;37029;17500809.511815;639.895001;1;8539;3;8542
nsrand-ipx;37029;68640.000000;0.000000;3;51;1;52
nu120-pr12;37029;197775.000000;4.800000;2;45;0;45
nu120-pr3;37029;511253.750000;28.016727;2;111;0;111
nu120-pr9;37029;334880.000000;15.750000;2;82;0;82
nu25-pr12;37029;297882.500000;4.233333;2;42;0;42
nu4-pr9;37029;481275.000000;12.713333;2;75;0;75
nu60-pr9;37029;386150.000000;12.150000;2;82;0;82
nucorsav;37029;29.046100;79.993750;1;71340;134;71474
nursesched-medium-hint03;37029;33.468485;463.947617;1;1191;4;1195
nursesched-medium04;37029;452.000000;371.763072;2;896;7;903
nursesched-sprint-hidden09;37029;516.944444;178.989683;2;352;2;354
nursesched-sprint-late03;37029;34.254806;182.557279;1;350;1;351
nursesched-sprint02;37029;131.416667;138.065972;2;250;3;253
nw04;37029;16310.666667;2.000000;1;182;3;185
ofi;37029;6135598681.449045;1321.867570;196;3737;94;3831
ofi2;37029;6128453035.160096;1604.443623;184;6077;146;6223
oocsp-racks030e6cci;37029;0.000000;584.128665;15;163;10;173
opm2-z10-s2;37029;-21344.000000;-0.000000;5;6372;6;6378
opm2-z10-s4;37029;-20011.000000;-0.000000;5;6802;6;6808
opm2-z11-s8;37029;-24077.000000;0.000000;5;11205;9;11214
opm2-z12-s14;37029;-38546.000000;-0.000000;5;24729;12;24741
opm2-z12-s7;37029;-33919.000000;-0.000000;5;25242;11;25253
opm2-z12-s8;37029;-35083.000000;0.000000;6;28264;13;28277
opm2-z6-s1;37029;-2356.000000;-0.000000;3;255;0;255
opm2-z7-s2;37029;-7132.000000;-0.000000;4;517;1;518
opm2-z7-s8;37029;-6856.000000;-0.000000;4;556;1;557
opm2-z8-s0;37029;-8004.000000;0.000000;3;1311;1;1312
opt1217;37029;-20.021390;9.254902;1;2;0;2
osorio-cta;37029;0.000000;0.013388;1;55;0;55
p0201;37029;7155.000000;10.900000;1;1;0;1
p100x588b;37029;58977.000000;0.000000;2;1;0;1
p200x1188c;37029;15747.000000;0.000000;2;3;0;3
p2756;37029;2706.000000;24.070313;2;4;0;4
p500x2988;37029;72594.000000;0.000000;2;31;0;31
p500x2988c;37029;17212.000000;-0.000000;2;29;0;29
p500x2988d;37029;6.000000;-0.000000;2;26;0;26
p6b;37029;-53.000000;0.000000;3;52;0;52
p80x400b;37029;45896.000000;-0.000000;2;1;0;1
pb-fit2d;37029;-22363.768555;843.273209;1;6685;11;6696
pb-gfrd-pnc;37029;8321.694589;42.993642;1;109;0;109
pb-grow22;37029;-449654.852582;117.814534;1;427;1;428
pb-market-split8-70-4;37029;0.000000;1.843507;1;0;0;0
pb-simp-nonunif;37029;9.500000;316.333333;3;2470;7;2477
peg-solitaire-a3;37029;1.000000;282.122203;1;336;0;336
pg;37029;-11098.657382;17.215049;2;5;0;5
pg5_34;37029;-16012.248077;18.476238;2;6;0;6
physiciansched3-3;37029;2590923.193775;699.205074;3;16428;4;16432
physiciansched3-4;37029;1459495.744406;487.330856;3;18070;3;18073
physiciansched5-3;37029;20464.000000;300.675473;2;761;1;762
physiciansched6-1;37029;10067.500000;253.698611;3;755;2;757
physiciansched6-2;37029;47675.160783;435.646407;4;388;1;389
pigeon-08;37029;-8000.000000;4.485714;1;2;0;2
pigeon-10;37029;-10000.000000;8.022222;1;3;0;3
pigeon-11;37029;-11000.000000;9.020000;1;3;0;3
pigeon-12;37029;-12000.000000;10.018182;1;3;0;3
pigeon-13;37029;-13000.000000;11.016667;1;4;0;4
pigeon-16;37029;-16000.000000;34.984242;1;5;0;5
pigeon-19;37029;-19000.000000;17.011111;1;7;0;7
pigeon-20;37029;-20000.000000;26.250718;1;8;0;8
piperout-03;37029;69590.490975;247.390162;7;327;2;329
piperout-08;37029;99228.924471;290.586596;43;282;15;297
piperout-27;37029;7146.876623;511.484386;353;358;139;497
piperout-d20;37029;25601.416667;437.748324;2;831;1;832
piperout-d27;37029;7199.340391;682.880995;2;983;2;985
pk1;37029;0.000000;2.791536;1;0;0;0
polygonpack3-15;37029;-114051612.169520;44.756601;3;1116;6;1122
polygonpack4-10;37029;-93676953.470100;20.074246;3;384;2;386
polygonpack4-15;37029;-114052801.790860;41.993372;3;1117;6;1123
polygonpack4-7;37029;-75324958.874200;9.351513;3;191;1;192
polygonpack5-15;37029;-66029981.130960;32.055340;3;1175;5;1180
pp08a;37029;15000.000000;-0.000000;2;0;0;0
pp08aCUTS;37029;16630.402442;0.000000;2;2;0;2
probportfolio;37029;7.321966;24.067729;1;3;0;3
prod1;37029;-55.000000;3.767946;2;1;0;1
prod2;37029;-59.000000;4.566580;2;4;0;4
proteindesign121hz512p19;37029;3197.772133;54.952462;1;5586;60;5646
proteindesign121hz512p9;37029;1423.904449;59.959446;1;196;3;199
proteindesign121pgb11p9;37029;1173.710433;48.788284;1;173;3;176
proteindesign122trx11p8;37029;1720.461105;46.139777;1;181;3;184
protfold;37029;0.000000;35.000000;2;19;0;19
pw-myciel4;37029;4.000000;91.886923;4;6;0;6
pythago7824;37029;0.000000;580.777778;6;992;2;994
pythago7825;37029;0.000000;586.777778;8;789;3;792
qap10;37029;332.566228;55.000000;1;364;0;364
qiu;37029;1805.177158;0.000000;2;5;0;5
qnet1;37029;89045.940000;7.221868;2;17;0;17
qnet1_o;37029;93221.720000;0.000000;2;5;0;5
queens-30;37029;-30.000000;0.000000;3;187;1;188
r4l4-02-tree-bounds-50;37029;512370030.000000;648.050000;3;39;0;39
r50x360;37029;2016.000000;-0.000000;2;1;0;1
r80x800;37029;5520.000000;-0.000000;2;2;0;2
radiationm18-12-05;37029;17561.353680;194.350613;2;61;0;61
radiationm40-10-02;37029;155317.684921;720.535635;2;273;2;275
rail01;37029;-90.767086;1608.458333;1;14556;4;14560
rail02;37029;-206.092110;2192.100000;1;118743;8;118751
rail03;37029;-919.222126;7600.659028;1;178988;24;179012
rail507;37029;207.000000;-0.000000;3;253;4;257
railway_8_1_0;37029;397.000000;48.637052;3;5;0;5
ramos3;37029;440.000000;-0.000000;3;1427;0;1427
ran12x21;37029;4080.000000;0.000000;2;0;0;0
ran13x13;37029;3521.000000;0.000000;2;0;0;0
ran14x18-disj-8;37029;12170.996653;0.000000;2;17;0;17
ran14x18;37029;4265.000000;0.000000;2;0;0;0
ran16x16;37029;4333.000000;0.000000;2;0;0;0
rd-rplusc-21;37029;100.000000;2.533849;1;327;0;327
reblock115;37029;-37981832.798944;238.100873;1;223;0;223
reblock166;37029;-640892721.079106;86.859092;6;319;0;319
reblock354;37029;-39586262.751951;411.245436;1;966;0;966
reblock420;37029;-558825455.521724;213.947318;7;1682;3;1685
reblock67;37029;-36575497.117631;131.415935;1;40;0;40
rfds-4-days;37029;-1158940.978167;66.375000;1;18090;10;18100
rlp1;37029;13.244444;9.961905;1;1;0;1
rmatr100-p10;37029;360.593308;9.692735;1;321;0;321
rmatr100-p5;37029;762.040054;5.000000;1;502;0;502
rmatr200-p10;37029;1550.620783;10.000000;1;11115;0;11115
rmatr200-p20;37029;688.357943;19.982266;1;3440;0;3440
rmatr200-p5;37029;3283.653831;5.000000;1;11694;0;11694
rmine10;37029;-1926.863820;886.708002;1;3441;1;3442
rmine11;37029;-2522.047107;1304.350285;1;9386;1;9387
rmine13;37029;-3504.619914;1108.274293;2;24019;6;24025
rmine14;37029;-4310.694704;2228.265999;1;109427;3;109430
rmine15;37029;-5042.482963;4267.046917;1;222809;6;222815
rmine6;37029;-462.305727;106.725097;1;136;0;136
rocI-3-11;37029;-110705.000000;60.123309;41;11;1;12
rocI-4-11;37029;-11110705.000000;62.940609;17;34;1;35
rocII-10-11;37029;-11.946851;218.008590;1;866;0;866
rocII-4-11;37029;-11.867128;49.198977;2;52;0;52
rocII-5-11;37029;-11.893702;59.199453;2;75;0;75
rocII-7-11;37029;-11.924073;123.003930;1;174;0;174
rocII-8-11;37029;-11.933564;163.387203;1;264;0;264
rocII-9-11;37029;-11.940946;185.545672;1;627;0;627
rococoB10-011000;37029;51207.000000;10.950589;5;109;0;109
rococoC10-001000;37029;23730.000000;0.000000;6;21;0;21
rococoC11-010100;37029;143170.000000;22.416868;2;149;0;149
rococoC11-011100;37029;139407.000000;14.937663;2;109;0;109
rococoC12-010001;37029;117774.000000;9.895179;2;210;1;211
rococoC12-111000;37029;27337.357381;31.147270;1;273;0;273
roi2alpha3n4;37029;-78.888089;8.000000;2;635;9;644
roi5alpha10n8;37029;-84.342241;16.000000;2;1929;24;1953
roll3000;37029;11939.645814;52.881579;2;25;0;25
rout;37029;981.864286;10.233819;1;2;0;2
rpp22falsei;37029;0.000000;104.907502;4;70;1;71
rvb-sub;37029;11.206514;4.857143;1;690;5;695
s100;37029;-0.170525;50.899744;1;20046;18;20064
s1234;37029;0.361925;1.572046;4;2650;1;2651
s250r10;37029;-0.166732;98.897856;2;9453;26;9479
s55;37029;-22.151773;60.323192;1;1439;3;1442
satellites1-25;37029;-20.000000;116.648535;1;632;0;632
satellites2-25;37029;-29.000000;481.917605;1;32809;2;32811
satellites2-40;37029;-29.000000;388.670807;1;30250;2;30252
satellites2-60-fs;37029;-23.852708;435.801124;2;4069;2;4071
satellites2-60;37029;-29.000000;388.670807;1;30503;2;30505
satellites3-25;37029;-38.000000;665.662922;1;242201;5;242206
satellites3-40-fs;37029;-32.672442;842.911524;2;26961;7;26968
satellites3-40;37029;-38.000000;772.480914;1;288094;5;288099
savsched1;37029;8245.900000;-0.000000;3;63107;43;63150
scpj4scip;37029;183.000000;-0.000000;3;1384;25;1409
scpk4;37029;389.000000;0.000000;3;2788;23;2811
scpl4;37029;360.000000;-0.000000;3;5405;51;5456
scpm1;37029;774.000000;0.000000;3;46013;122;46135
scpn2;37029;741.000000;0.000000;3;70815;252;71067
sct1;37029;-186.838854;85.284884;2;949;1;950
sct2;37029;-37.690825;16.582400;2;55;0;55
sct31;37029;177.033470;23.501154;2;199;0;199
sct32;37029;51.266438;45.043874;2;502;1;503
sct5;37029;-227.069807;28.088069;2;510;2;512
seqsolve1;37029;4770.293168;265.188388;24;5546;135;5681
seqsolve2short4288;37029;20.396875;318.804378;4;7334;30;7364
seqsolve3short4288excess384;37029;-43472.799518;407.473201;8;10634;48;10682
set1ch;37029;107691.500000;-0.000000;2;1;0;1
set3-09;37029;1263.077974;13.704533;2;11;0;11
set3-10;37029;788.890655;13.953500;2;10;0;10
set3-15;37029;8364.040745;17.365117;2;16;0;16
set3-16;37029;9916.808562;19.040932;2;15;0;15
set3-20;37029;10347.381087;16.724301;2;11;0;11
seymour-disj-10;37029;331.000001;-0.000000;4;1757;2;1759
seymour;37029;452.000000;0.000000;3;225;0;225
seymour1;37029;419.891318;-0.000000;3;205;0;205
shiftreg1-4;37029;131.656032;178.150000;1;33;0;33
shiftreg2-7;37029;206.733052;119.762169;1;75;0;75
shiftreg5-1;37029;520.839888;534.303103;1;382;0;382
shipsched;37029;-0.000000;8.077417;4;75;1;76
shipschedule3shipsi;37029;-265650.000000;386.462789;12;55;2;57
shipschedule6shipsmixi;37029;-301650.000000;714.731050;9;84;4;88
shipschedule8shipsmixuci;37029;-401100.000000;525.771813;11;104;5;109
shs1014;37029;22137.410363;320.475000;1;37632;18;37650
shs1042;37029;10404.662711;568.781970;1;35838;23;35861
siena1;37029;10163179.229002;146.859338;1;1626;2;1628
sing11;37029;18640171.224643;243.132649;1;7404;4;7408
sing161;37029;19071259.113926;685.480441;1;68166;22;68188
sing17;37029;35483848.876513;472.456436;1;27061;11;27072
sing2;37029;17150914.716940;256.737979;1;1926;1;1927
sing245;37029;25024015.754083;395.965975;1;13437;6;13443
sing326;37029;7717674.801189;172.968798;1;2512;2;2514
sing359;37029;22534478.962498;889.129081;1;87228;18;87246
sing44;37029;8102513.219400;139.469372;1;3112;2;3114
sing5;37029;18418516.013137;236.754039;1;2854;4;2858
snip10x10-35r1budget17;37029;30.000000;3.224794;2;1390;0;1390
snp-02-004-104;37029;567161691.779774;7.604965;5;5374;0;5374
snp-04-052-052;37029;746313354.490274;733.799382;6;4644;3;4647
snp-06-004-052;37029;1831976376.522612;31.156229;2;8263;0;8263
snp-10-004-052;37029;5961214167.823297;42.379535;6;20239;2;20241
snp-10-052-052;37029;6009206679.336597;1683.882989;6;21865;8;21873
sorrell3;37029;-13.000000;-0.000000;3;373;0;373
sorrell4;37029;-18.000000;-0.000000;3;1090;2;1092
sorrell7;37029;-141.000000;0.000000;3;14672;0;14672
sorrell8;37029;-269.000000;0.000000;3;196;0;196
sp150x300d;37029;71.000000;0.000000;2;0;0;0
sp97ar;37029;815120355.519999;2.342794;4;401;6;407
sp97ic;37029;578703486.755542;0.975543;3;384;4;388
sp98ar;37029;648426163.072905;1.440725;4;569;7;576
sp98ic;37029;605964163.117924;3.283712;5;358;8;366
sp98ir;37029;271833089.651983;6.757325;5;54;1;55
splice1k1;37029;-3.068619;1.426914;2;33147;19;33166
splice1k1i;37029;-1646.777979;134.969052;1;13351;3;13354
square23;37029;8.333333;12.444444;1;96;1;97
square31;37029;8.500000;13.750000;1;482;4;486
square37;37029;8.666667;15.000000;1;1399;10;1409
square41;37029;8.839612;15.068891;1;2071;16;2087
square47;37029;8.755814;15.976744;1;6134;29;6163
stoch-vrpvrp-s5v2c8vrp-v2c8i;37029;0.000000;90.492376;3;11;0;11
stockholm;37029;171.000000;0.000000;2;467;0;467
stp3d;37029;564.338735;444.504657;2;24881;13;24894
sts405;37029;357.000000;0.000000;2;586;2;588
sts729;37029;665.000000;0.000000;2;3688;5;3693
supportcase1;37029;20078.000000;0.020832;2;242;4;246
supportcase10;37029;3.383924;971.624635;2;8948;5;8953
supportcase11;37029;-14.281996;0.000000;1;4;0;4
supportcase12;37029;-7559.533054;69.133766;1;1827;0;1827
supportcase14;37029;272.000000;7.333333;1;3;0;3
supportcase16;37029;272.000000;7.333333;1;2;0;2
supportcase17;37029;0.000000;31.823189;2;6;0;6
supportcase18;37029;87.000000;9.141806;2;43;0;43
supportcase19;37029;12677206.000000;370.390975;1;26397;62;26459
supportcase2;37029;0.000000;4.750000;1;9285;52;9337
supportcase20;37029;108889.000000;0.000000;2;15;0;15
supportcase23;37029;-12952.000000;617.629502;1;1650;0;1650
supportcase25;37029;0.036932;11.225052;1;99;0;99
supportcase26;37029;1288.102161;0.009948;2;1;0;1
supportcase27i;37029;0.000000;88.605078;2;7;0;7
supportcase3;37029;0.000000;403.282880;3;203;0;203
supportcase30;37029;0.000000;102.857020;1;59;0;59
supportcase31;37029;79524.180000;4.000000;2;1942;58;2000
supportcase33;37029;-465.000000;27.827948;2;121;0;121
supportcase34;37029;72.664116;202.268052;1;529;1;530
supportcase35;37029;174371.000000;0.000000;2;93;0;93
supportcase37;37029;-5803.552159;23.221484;2;1023;0;1023
supportcase39;37029;-1062330.369524;22.808785;5;93;7;100
supportcase4;37029;0.000000;202.915359;3;165;0;165
supportcase40;37029;22536.483379;19.000000;1;225;0;225
supportcase41;37029;28.000000;52.930348;3;685;0;685
supportcase42;37029;7.343539;48.081295;1;1601;2;1603
supportcase43;37029;0.000000;48.147044;2;44716;3;44719
supportcase6;37029;45090.732163;29.123967;1;1652;9;1661
supportcase7;37029;-2396.218213;53.147310;2;1693;0;1693
swath;37029;334.496858;2.200000;1;45;0;45
swath1;37029;334.496858;0.600000;1;37;0;37
swath2;37029;334.496858;0.700000;1;35;0;35
swath3;37029;334.496858;0.800000;1;35;0;35
t1717;37029;134531.021428;79.098998;1;233;1;234
t1722;37029;98815.407611;52.399108;1;170;0;170
ta1-UUM;37029;3693674.556772;4.303412;1;5;0;5
ta2-UUE;37029;41427354.755773;0.680983;2;216;0;216
tanglegram1;37029;0.000000;46.000000;1;2;0;2
tanglegram2;37029;1.000000;26.500000;1;2;0;2
tanglegram4;37029;4.000000;71.000000;1;4;0;4
tanglegram6;37029;0.000000;33.500000;1;1;0;1
tbfp-bigm;37029;-178.153988;30.000000;1;165;0;165
tbfp-network;37029;23.261535;31.000000;1;842;3;845
Test3;37029;2671255.210245;12.061384;1;105;0;105
thor50dday;37029;203930.000000;0.000000;2;238;4;242
timtab1;37029;1219185.333333;17.766667;2;2;0;2
timtab1CUTS;37029;613590.095426;34.399586;2;5;0;5
timtab2;37029;1602354.333333;29.200000;2;1;0;1
tokyometro;37029;4757.557930;269.160152;3;65;0;65
toll-like;37029;28.000000;229.000000;1;32;0;32
tpl-tub-ss16;37029;8128588.328716;1889.575939;3;86560;157;86717
tpl-tub-ws1617;37029;10755112.807538;2191.381057;3;96853;193;97046
tr12-30;37029;188435.464884;3.580258;2;1;0;1
traininstance2;37029;0.000000;8.032762;2;61;0;61
traininstance6;37029;0.000000;3.486662;2;32;0;32
transportmoment;37029;-55084931301.156029;426.403696;2;189;0;189
trento1;37029;5182758.848056;78.562537;1;517;0;517
triptim1;37029;22.944100;1699.491642;3;7195;7;7202
triptim2;37029;11.877783;541.310145;3;11146;8;11154
triptim3;37029;14.144151;636.713323;3;11928;9;11937
triptim4;37029;9.521100;370.684028;3;11087;8;11095
triptim7;37029;3096.288157;499.722459;2;11131;5;11136
triptim8;37029;3074.310409;496.632366;2;12096;5;12101
tw-myciel4;37029;22.000000;73.880282;5;170;0;170
uc-case11;37029;611621.305979;118.843629;1;2715;0;2715
uc-case3;37029;7181.432113;95.258578;3;1948;1;1949
uccase10;37029;38995.965187;400.440843;1;2600;2;2602
uccase12;37029;11507.474829;29.321333;3;2134;3;2137
uccase7;37029;26527.823515;162.338874;1;3498;0;3498
uccase8;37029;11142.163196;63.982247;1;1401;0;1401
uccase9;37029;10819.582996;76.021210;1;929;0;929
uct-subprob;37029;242.000000;57.184617;1;55;0;55
umts;37029;43380098.519492;76.628947;2;17;0;17
unitcal_7;37029;19450489.742819;144.660904;6;815;1;816
usAbbrv-8-25_70;37029;95.000000;101.141743;3;7;0;7
usafa;37029;178.602081;3104.483345;2;46709;26;46735
v150d30-2hopcds;37029;52.000000;-0.000000;3;108;1;109
van;37029;3.717453;12.910186;1;6495;0;6495
var-smallemery-m6j6;37029;-156.056268;89.220998;2;1121;4;1125
vpm2;37029;15.721505;3.393512;2;0;0;0
vpphard;37029;0.000000;124.135354;1;89;1;90
vpphard2;37029;0.000000;230.844444;1;84;0;84
wachplan;37029;-9.000000;60.204074;1;10;0;10
wnq-n100-mw99-14;37029;224.318143;77.196581;2;122;1;123
xmas10-2;37029;-537.008669;157.129457;1;240;0;240
xmas10;37029;-537.008669;157.318400;1;201;0;201
z26;37029;-979.000000;0.000000;3;12747;9;12756
zeil;37029;813.510308;818.615660;1;82005;6;82011
zib54-UUE;37029;19164366.000000;-0.000000;2;48;0;48
10teams;1206151;917.000000;36.457830;1;32;0;32
22433;1206151;21552.708079;24.962328;5;7;0;7
23588;1206151;8342.863244;17.617619;4;3;0;3
2club200v15p5scn;1206151;-97.038462;36.192308;4;141;2;143
30n20b8;1206151;5530.000000;41.625765;2;119;0;119
30_70_45_05_100;1206151;67.000000;-0.000000;5;945;2;947
30_70_45_095_100;1206151;48.000000;-0.000000;5;851;2;853
30_70_45_095_98;1206151;326.000000;-0.000000;5;808;3;811
50v-10;1206151;1493601.476062;-0.000000;2;5;0;5
a1c1s1;1206151;20885.065088;0.498062;2;8;0;8
a2c1s1;1206151;21087.746318;-0.000000;2;8;0;8
ab51-40-100;1206151;-437558462.000004;11.050000;2;458;1;459
ab67-40-100;1206151;-11186253442.000000;0.000000;1;313;0;313
ab69-40-100;1206151;-11186281442.000000;0.000000;1;301;0;301
ab71-20-100;1206151;-2390446504.400002;12.500000;2;236;0;236
ab72-40-100;1206151;-11186620442.000000;0.000000;1;341;0;341
academictimetablebig;1206151;427.000000;1954.919056;2;25672;17;25689
academictimetablesmall;1206151;0.000000;308.966235;2;225;2;227
acc-tight2;1206151;0.000000;120.187623;1;25;0;25
acc-tight4;1206151;0.000000;120.929764;1;24;0;24
acc-tight5;1206151;0.000000;107.821033;1;187;0;187
acc-tight6;1206151;0.000000;104.011436;1;182;0;182
adult-max5features;1206151;10710.000597;0.023689;2;931;8;939
adult-regularized;1206151;7841.000000;0.000000;3;2038;9;2047
aflow30a;1206151;1402.717622;2.301497;3;2;0;2
aflow40b;1206151;1129.417647;2.760099;3;6;0;6
air03;1206151;338864.250000;11.375000;1;56;0;56
air04;1206151;55535.436388;51.829962;1;173;0;173
air05;1206151;25877.609268;45.880497;1;124;0;124
aligninq;1206151;2755.000000;40.921868;7;16;1;17
allcolor10;1206151;1517.912903;297.924236;4;106;2;108
allcolor58;1206151;6718.838624;1820.373386;4;781;10;791
amaze22012-03-15i;1206151;0.000000;58.255984;2;87;2;89
amaze22012-06-28i;1206151;0.000000;35.368753;2;28;0;28
amaze22012-07-04i;1206151;0.000000;43.156843;2;40;0;40
app1-1;1206151;-2.000000;1.945752;2;6;0;6
app1-2;1206151;-23.000000;1.399234;3;308;1;309
app2-1;1206151;19294.250000;0.000000;2;19;0;19
app2-2;1206151;212092.500000;0.000000;2;1;0;1
app3;1206151;5627412.287938;3.142492;1;8;0;8
arki001;1206151;7579621.830840;15.454670;1;31;0;31
assign1-10-4;1206151;353.992926;52.000000;1;36;0;36
assign1-5-8;1206151;183.362555;24.000000;1;2;0;2
atlanta-ip;1206151;81.321096;294.518627;2;5660;2;5662
atm20-100;1206151;2141734.684878;120.774021;2;71;0;71
australia-abs-cta;1206151;0.000000;38.185342;1;65;0;65
b-ball;1206151;-1.818182;4.818182;1;0;0;0
b1c1s1;1206151;69995.090000;-0.000000;2;7;0;7
b2c1s1;1206151;69710.660000;-0.000000;2;14;0;14
bab1;1206151;-228225.182825;27.775000;1;97;0;97
bab2;1206151;-338400.636000;244.500000;2;12485;17;12502
bab3;1206151;-555805.926583;450.995536;2;28337;41;28378
bab5;1206151;-106670.400850;101.900000;2;567;2;569
bab6;1206151;-246114.832525;480.833333;2;5345;12;5357
bc;1206151;13.915046;0.268421;2;103;0;103
bc1;1206151;4.550543;0.028778;2;95;0;95
beasleyC1;1206151;102.000000;0.000000;2;3;0;3
beasleyC2;1206151;232.000000;0.000000;2;3;0;3
beasleyC3;1206151;951.000000;-0.000000;2;4;0;4
beavma;1206151;395292.332242;3.472328;2;1;0;1
berlin;1206151;1951.000000;0.000000;2;29;0;29
berlin_5_8_0;1206151;52.000000;58.057245;3;2;0;2
bg512142;1206151;506799.440536;51.840309;3;30;0;30
biella1;1206151;3060037.430763;98.993456;1;271;0;271
bienst1;1206151;11.724138;4.390524;1;2;0;2
bienst2;1206151;11.724138;5.390524;1;2;0;2
binkar10_1;1206151;6637.188027;9.084811;1;8;0;8
blend2;1206151;7.489992;0.686573;2;0;0;0
bley_xl1;1206151;265.192657;294.413130;3;21256;11;21267
bley_xs1;1206151;47020884.968217;85.931545;3;73;0;73
bley_xs1noM;1206151;60185433.134379;90.542003;2;61;0;61
bley_xs2;1206151;30478761.025431;42.229522;12;12;1;13
blp-ar98;1206151;9174.508280;11.800505;21;96;25;121
blp-ic97;1206151;5423.588709;1.337703;12;65;8;73
blp-ic98;1206151;6879.499245;1.657910;4;129;4;133
blp-ir98;1206151;3350.173368;3.875758;3;40;1;41
bmocbd3;1206151;45423160382.724037;0.000000;2;17655;12;17667
bmoipr2;1206151;-46628940.711029;7.840017;1;65;0;65
bnatt350;1206151;0.000000;109.506930;17;86;2;88
bnatt400;1206151;0.000000;127.888934;17;133;2;135
bppc4-08;1206151;51.590000;13.322623;1;21;0;21
bppc6-02;1206151;108.340000;11.296538;1;127;1;128
bppc6-06;1206151;200.633333;13.595370;1;146;0;146
bppc8-02;1206151;486.500000;3.194588;1;1;0;1
bppc8-09;1206151;444.436047;4.775100;1;3;0;3
brasil;1206151;32311.000000;0.000000;2;26;0;26
brazil3;1206151;2.000000;254.754201;2;201;0;201
breastcancer-regularized;1206151;105.150036;0.002191;2;8;0;8
bts4-cta;1206151;33524.637606;1130.000000;1;510;0;510
buildingenergy;1206151;33246.215059;1468.850000;2;15884;4;15888
cap6000;1206151;-2446875.000000;0.000000;3;40;0;40
cbs-cta;1206151;0.000000;27.746030;1;103;0;103
cdc7-4-3-2;1206151;-231.000000;-0.000000;3;36591;5;36596
chromaticindex1024-7;1206151;4.000000;16002.682953;2;2310;9;2319
chromaticindex128-5;1206151;4.000000;2021.163699;2;145;1;146
chromaticindex256-8;1206151;4.000000;4069.477083;2;367;2;369
chromaticindex32-8;1206151;4.000000;504.887500;2;17;0;17
chromaticindex512-7;1206151;4.000000;8183.527137;2;1135;4;1139
ci-s4;1206151;17.644894;41.881015;3;9;0;9
circ10-3;1206151;140.000000;209.309855;1;2002;1;2003
cmflsp40-24-10-7;1206151;52605868.952858;70.700930;3;381;0;381
cmflsp40-36-2-10;1206151;72898024.959478;295.649246;3;763;0;763
cmflsp50-24-10-4;1206151;64492612.641644;81.236085;3;334;0;334
cmflsp50-24-8-8;1206151;59814378.749021;131.869460;3;334;0;334
cmflsp60-36-2-6;1206151;97887903.946142;370.689759;3;1799;0;1799
CMS750_4;1206151;250.000000;233.284641;3;68;1;69
co-100;1206151;1246685.546783;10.401691;2;329;8;337
cod105;1206151;-8.000000;0.000000;3;486;1;487
comp07-2idx;1206151;0.000000;114.416667;2;1897;1;1898
comp08-2idx;1206151;0.000000;159.969397;1;142;0;142
comp12-2idx;1206151;3.000000;267.951781;1;1200;0;1200
comp16-3idx;1206151;4.000000;721.111978;1;7057;2;7059
comp21-2idx;1206151;0.000000;282.023529;3;475;1;476
control30-3-2-3;1206151;-20763026.787568;27.970540;1;4;0;4
core2536-691;1206151;786.000000;-0.000000;3;782;2;784
core2586-950;1206151;1169.000000;-0.000000;3;560;1;561
core4284-1064;1206151;1275.000000;0.000000;3;3047;3;3050
core4872-1529;1206151;1850.000000;0.000000;3;1681;3;1684
cost266-UUE;1206151;42001606.280000;-0.000000;2;65;0;65
cov1075;1206151;35.000000;0.000000;2;6;0;6
cryptanalysiskb128n5obj16;1206151;0.000000;5029.990887;106;1187;209;1396
csched007;1206151;269.251587;22.185714;1;39;0;39
csched008;1206151;171.000000;24.778341;1;11;0;11
csched010;1206151;332.422727;20.512626;1;32;0;32
cvrpa-n64k9vrpi;1206151;0.000000;148.788980;2;439;4;443
cvrpb-n45k5vrpi;1206151;0.000000;104.481361;2;149;2;151
cvrpp-n16k8vrpi;1206151;0.000000;38.707224;1;34;0;34
cvrpsimple2i;1206151;0.000000;22.941208;2;2;0;2
cvs08r139-94;1206151;-16.000000;66.000000;3;14;0;14
cvs16r106-72;1206151;-2.000000;71.000000;2;28;0;28
cvs16r128-89;1206151;-2.000000;88.000000;2;35;0;35
cvs16r70-62;1206151;-0.000000;62.000000;2;27;0;27
cvs16r89-60;1206151;-0.000000;60.000000;2;31;0;31
d10200;1206151;12425.583005;32.097057;1;40;0;40
d20200;1206151;12229.625788;62.339279;1;298;0;298
dale-cta;1206151;0.000000;0.004766;1;282;0;282
dano3mip;1206151;576.231620;15.297311;1;2025;0;2025
dano3_3;1206151;576.231620;1.932181;1;2061;0;2061
dano3_5;1206151;576.231620;2.871834;1;2135;0;2135
danoint;1206151;62.637280;5.819184;1;18;0;18
dc1c;1206151;1754946.863638;140.593306;1;280;0;280
dc1l;1206151;211357921.003601;0.000000;3;821;17;838
dcmulti;1206151;184917.234283;12.662065;3;3;0;3
decomp1;1206151;-120.000000;149.444444;1;40;0;40
decomp2;1206151;-160.000000;141.944444;1;41;0;41
dfn-bwin-DBE;1206151;797567.400000;0.000000;2;32;0;32
dfn-gwin-UUM;1206151;27467.257235;5.653537;1;1;0;1
dg012142;1206151;7485691.825683;37.560751;5;116;0;116
diameterc-mstc-v20a190d5i;1206151;291.000000;288.954791;3;58;0;58
diameterc-msts-v40a100d5i;1206151;324.000000;347.153926;3;57;0;57
disctom;1206151;-5000.000000;51.166667;1;172;0;172
disktom;1206151;-5000.000000;51.166667;1;179;0;179
dolom1;1206151;6556066.068315;111.218954;1;452;1;453
drayage-100-12;1206151;91134.076080;32.228466;1;47;0;47
drayage-100-23;1206151;103333.874073;41.554651;1;41;0;41
drayage-25-23;1206151;99718.790531;39.569924;1;54;0;54
drayage-25-27;1206151;95207.144904;44.816549;1;45;0;45
drayage-25-32;1206151;88256.306534;44.499212;1;50;0;50
ds-big;1206151;86.820068;30.669231;1;7018;21;7039
ds;1206151;57.234565;33.463549;1;908;6;914
dws008-01;1206151;2954.537147;2.158177;2;51;0;51
dws008-03;1206151;3283.316973;6.687361;2;151;1;152
dws012-01;1206151;5179.177491;3.971756;2;100;1;101
dws012-02;1206151;4705.864492;24.017311;3;214;3;217
dws012-03;1206151;5237.420078;17.786054;3;356;6;362
eil33-2;1206151;811.278996;3.615630;1;33;0;33
eilA101-2;1206151;803.373888;7.408683;1;846;6;852
eilB101;1206151;1075.247691;12.807028;1;19;0;19
eilC76-2;1206151;725.754458;7.780208;1;271;2;273
ej;1206151;1.000000;0.243844;1;0;0;0
elitserienhandball11i;1206151;0.000000;866.305983;2;430;1;431
elitserienhandball13i;1206151;0.000000;853.141952;2;423;1;424
elitserienhandball14i;1206151;0.000000;883.858328;2;377;1;378
elitserienhandball3i;1206151;0.000000;887.935483;2;394;1;395
enlight13;1206151;1.000000;1.000000;1;0;0;0
enlight15;1206151;1.000000;1.000000;1;0;0;0
enlight8;1206151;1.000000;1.000000;1;0;0;0
enlight_hard;1206151;15.500000;17.000000;1;0;0;0
eva1aprime5x5opt;1206151;-497.155823;0.526297;1;263;0;263
eva1aprime6x6opt;1206151;-495.398833;1.239563;1;1782;0;1782
ex10;1206151;100.000000;98.000000;1;16873;5;16878
ex1010-pi;1206151;314.000000;-0.000000;3;467;2;469
ex9;1206151;81.000000;75.601201;1;1784;2;1786
exp-1-500-5-5;1206151;97666.305541;4.045842;2;2;0;2
f2000;1206151;1383.000000;1280.000000;2;3409;0;3409
f2gap201600;1206151;76429.862296;1.402159;1;3;0;3
f2gap401600;1206151;82274.237434;1.190020;1;4;0;4
f2gap40400;1206151;20650.898154;3.253580;1;1;0;1
f2gap801600;1206151;86570.120867;5.266841;1;5;0;5
fast0507;1206151;205.000000;-0.000000;3;182;3;185
fastxgemm-n2r6s0t2;1206151;27.000000;9.000000;1;49;0;49
fastxgemm-n2r7s4t1;1206151;27.000000;9.000000;1;36;0;36
fastxgemm-n3r21s3t6;1206151;84.000000;27.000000;1;2339;0;2339
fastxgemm-n3r22s4t6;1206151;84.000000;27.000000;1;2539;0;2539
fastxgemm-n3r23s5t6;1206151;84.000000;27.000000;1;2534;0;2534
fhnw-binpack4-48;1206151;0.000000;333.285714;2;133;0;133
fhnw-binpack4-58;1206151;0.000000;467.321429;2;114;0;114
fhnw-binpack4-77;1206151;0.000000;207.310714;2;111;0;111
fhnw-binschedule0;1206151;15642.000000;1053.297818;2;18982;26;19008
fhnw-binschedule2;1206151;2273.000000;221.912633;3;436;4;440
fhnw-schedule-paira100;1206151;-36.643681;5.149215;2;123;0;123
fhnw-schedule-paira200;1206151;-73.826479;8.940825;2;244;3;247
fhnw-schedule-paira400;1206151;-146.941079;19.266221;2;1200;11;1211
fhnw-schedule-pairb200;1206151;-58.887041;815.939903;3;2085;3;2088
fhnw-schedule-pairb400;1206151;-109.169750;2783.836162;3;12337;14;12351
fhnw-sq2;1206151;0.000000;13.695522;1;5;0;5
fiball;1206151;137.069168;72.169473;1;110;1;111
fiber;1206151;897538.360000;12.574421;2;2;0;2
fillomino7x7-0i;1206151;0.000000;304.793110;2;68;0;68
fixnet6;1206151;4536.000000;0.000000;2;1;0;1
fjspeasy01i;1206151;216.000000;1.364719;2;57;0;57
flugpl;1206151;1167875.166377;2.785325;1;0;0;0
g200x740;1206151;45614.000000;-0.000000;2;3;0;3
g200x740i;1206151;44069.000000;-0.000000;2;3;0;3
gasprod1-1;1206151;10207.782090;23.384117;32;486;6;492
gasprod1-2;1206151;12418.693782;43.662702;18;299;3;302
gasprod1-3;1206151;13830.718570;40.837432;64;306;11;317
gasprod2-1;1206151;1510393.402354;44.156867;6;1079;1;1080
gasprod2-2;1206151;1355909.537507;297.110788;36;1717;13;1730
gen-ip002;1206151;-511.036897;0.000000;3;0;0;0
gen-ip016;1206151;-9505.628173;1.906914;1;0;0;0
gen-ip021;1206151;6642.052620;2.217259;4;0;0;0
gen-ip036;1206151;-2162.833562;0.000000;3;0;0;0
gen-ip054;1206151;7350.684932;1.502477;8;0;0;0
gen;1206151;112555.106141;0.427450;2;1;0;1
genus-g31-8;1206151;-27.000000;116.000000;1;1010;1;1011
genus-g61-25;1206151;-58.000000;199.000000;1;325;2;327
genus-sym-g31-8;1206151;-27.000000;150.889800;2;3202;3;3205
genus-sym-g62-2;1206151;-54.000000;225.350434;1;22813;1;22814
genus-sym-grafo5708-48;1206151;-27.000000;159.026027;2;1506;0;1506
ger50-17-ptp-pop-3t;1206151;3466.323207;45.213645;1;109;0;109
ger50-17-ptp-pop-6t;1206151;6804.447088;50.477969;1;96;0;96
ger50-17-trans-dfn-3t;1206151;3453.475245;37.741927;1;174;1;175
ger50-17-trans-pop-3t;1206151;3456.252922;49.487013;1;169;1;170
ger50_17_trans;1206151;6850.628623;48.226110;1;149;1;150
germanrr;1206151;47650759.157540;58.297944;3;704;2;706
germany50-DBM;1206151;438028.000000;21.150000;1;132;0;132
germany50-UUM;1206151;597932.500000;26.450000;1;53;0;53
gesa2-o;1206151;25748173.191117;13.380406;2;4;0;4
gesa2;1206151;25502855.039680;8.989886;1;6;0;6
gfd-schedulen180f7d50m30k18-16i;1206151;21.533333;4366.403732;3;9196;155;9351
gfd-schedulen180f7d50m30k18;1206151;1.000000;6031.558267;6;3882;36;3918
gfd-schedulen25f5d20m10k3i;1206151;3.000000;29.157898;2;75;0;75
gfd-schedulen55f2d50m30k3i;1206151;5.000000;231.083604;2;220;3;223
ghoulomb4-9-10i;1206151;9.000000;9.160150;2;54;1;55
glass-sc;1206151;23.000000;0.000000;3;115;1;116
glass4;1206151;800002400.000000;8.568254;1;1;0;1
gmu-35-40;1206151;-2406943.556343;2.300342;1;4;0;4
gmu-35-50;1206151;-2608070.315743;3.444186;1;6;0;6
gmut-75-50;1206151;-14182312.661731;4.988967;1;471;3;474
gmut-76-40;1206151;-14171086.316075;9.054451;1;321;1;322
gmut-76-50;1206151;-14173884.188063;4.201959;1;373;3;376
gmut-77-40;1206151;-14173396.636852;2.973250;1;354;1;355
go19;1206151;96.000000;-0.000000;3;4;0;4
gr4x6;1206151;229.050000;-0.000000;2;0;0;0
graph20-20-1rand;1206151;-37.000000;43.000000;1;36;0;36
graph20-80-1rand;1206151;-110.000000;120.050000;2;1274;2;1276
graph40-20-1rand;1206151;-157.000000;175.500000;1;4134;2;4136
graph40-40-1rand;1206151;-300.000000;326.969290;1;93784;9;93793
graphdraw-domain;1206151;12672.000000;18.742857;1;2;0;2
graphdraw-gemcutter;1206151;4310.000000;12.048387;2;1;0;1
graphdraw-grafo2;1206151;35762.000000;350.966667;1;819;3;822
graphdraw-mainerd;1206151;30496.000000;131.370968;1;79;0;79
graphdraw-opmanager;1206151;54717.000000;210.091463;1;389;1;390
gsvm2rl11;1206151;35640.343493;0.000000;2;346;0;346
gsvm2rl12;1206151;50.000000;-0.000000;2;506;0;506
gsvm2rl3;1206151;0.600000;-0.000000;2;4;0;4
gsvm2rl5;1206151;10.000000;-0.000000;2;8;0;8
gsvm2rl9;1206151;16356.825869;0.000000;2;58;0;58
gt2;1206151;21166.000000;4.130952;2;0;0;0
h50x2450;1206151;11147.731511;3.696751;1;27;0;27
h80x6320;1206151;3700.000000;0.000000;1;24;0;24
h80x6320d;1206151;5325.160104;2.515625;1;44;0;44
hanoi5;1206151;1931.000000;245.237539;25;394;4;398
haprp;1206151;3679667.254486;41.766595;2;5;0;5
harp2;1206151;-74325169.345138;5.496152;1;2;0;2
hgms-det;1206151;-53793.320679;37.099950;1;192;0;192
hgms30;1206151;-53327.995245;51.804834;1;7436;0;7436
hgms62;1206151;-53394.446147;54.735370;1;14167;0;14167
hypothyroid-k1;1206151;-2846.896104;38.365286;3;7154;7;7161
ic97_potential;1206151;4084.000000;55.050000;2;3;0;3
ic97_tension;1206151;3993.000000;15.366667;2;2;0;2
icir97_potential;1206151;6589.000000;171.618362;2;39;0;39
icir97_tension;1206151;6323.000000;102.600000;2;4;0;4
iis-100-0-cov;1206151;41.000000;0.000000;3;102;0;102
iis-bupa-cov;1206151;49.000000;-0.000000;3;223;1;224
iis-glass-cov;1206151;28.000000;0.000000;3;140;1;141
iis-hc-cov;1206151;22.000000;0.000000;3;181;3;184
iis-pima-cov;1206151;41.000000;-0.000000;3;217;1;218
irp;1206151;12123.530222;6.000000;1;106;1;107
istanbul-no-cutoff;1206151;62.541409;3.968407;1;259;0;259
ivu06-big;1206151;135.427718;95.799872;1;52073;153;52226
ivu06;1206151;135.901353;96.981489;1;14130;56;14186
ivu52;1206151;480.250439;82.562257;1;6680;13;6693
ivu59;1206151;884.456993;122.808206;1;210117;221;210338
janos-us-DDM;1206151;1488134.750000;22.375000;1;8;0;8
k16x240;1206151;11359.000000;0.000000;2;1;0;1
k16x240b;1206151;12874.000000;0.000000;2;0;0;0
k1mushroom;1206151;-3747.840298;42.576586;3;19898;21;19919
k1mushroomi;1206151;-4165.061224;64.102041;1;14866;3;14869
khb05250;1206151;126785464.000000;0.000000;2;1;0;1
l2p12;1206151;2.000000;824.859960;3;222;1;223
l2p1i;1206151;1.000000;608.429261;2;960;20;980
l2p2i;1206151;1.000000;757.644602;2;128;1;129
lectsched-1-obj;1206151;36.000000;28.046924;4;214;3;217
lectsched-1;1206151;0.000000;6.882322;2;164;1;165
lectsched-2;1206151;0.000000;20.130091;3;81;1;82
lectsched-3;1206151;0.000000;4.358796;9;143;5;148
lectsched-4-obj;1206151;3.000000;15.019362;14;50;3;53
lectsched-5-obj;1206151;15.000000;54.733040;7;170;4;174
leo1;1206151;530605779.573215;2.950107;3;66;1;67
leo2;1206151;572818097.713015;1.549961;3;109;3;112
liu;1206151;346.000000;11.096532;2;5;0;5
loopha13;1206151;6.279000;1.132999;2;175;0;175
lotsize;1206151;1335747.052789;7.405615;2;6;0;6
lr1dr02vc05v8a-t360;1206151;120707.344638;169.266715;1;966;0;966
lr1dr04vc05v17a-t360;1206151;247150.518188;322.854834;1;1667;1;1668
lr1dr12vc10v70b-t360;1206151;983958.597196;1051.434951;1;42476;9;42485
lr2-22dr3-333vc4v17a-t60;1206151;-72770.836006;244.127587;2;34926;8;34934
lrn;1206151;44373752.713965;53.546052;2;410;0;410
m100n500k4r1;1206151;-20.000000;-0.000000;3;7;0;7
macrophage;1206151;35.000000;209.000000;1;7;0;7
mad;1206151;0.000000;5.072970;1;2;0;2
manna81;1206151;-11868.000000;0.000000;3;49;0;49
map06;1206151;-406.181173;7.868443;1;1103;0;1103
map10;1206151;-602.176181;11.248146;1;1071;0;1071
map14;1206151;-778.549324;11.962355;1;1086;0;1086
map14860-20;1206151;-998.836419;10.400693;1;1348;0;1348
map16715-04;1206151;-296.267898;4.997036;1;1186;0;1186
map18;1206151;-932.782685;11.173489;1;1491;0;1491
map20;1206151;-998.836419;10.400693;1;1439;0;1439
mappingmesh3x3mpeg2i;1206151;10000.000000;156.247882;2;28;0;28
mario-t-hard5i;1206151;-4482.000000;96.185417;1;165;1;166
markshare1;1206151;230.000000;-0.000000;2;0;0;0
markshare2;1206151;454.000000;0.000000;2;0;0;0
markshare_4_0;1206151;226.000000;0.000000;2;0;0;0
markshare_5_0;1206151;337.000000;0.000000;2;0;0;0
mas74;1206151;10482.795280;3.103514;1;1;0;1
mas76;1206151;38893.903641;2.555097;1;1;0;1
maxgasflow;1206151;-53620694.316699;218.049274;2;53;0;53
mc11;1206151;13520.000000;-0.000000;2;28;0;28
mc7;1206151;5797.000000;-0.000000;2;28;0;28
mc8;1206151;1944.000000;-0.000000;2;29;0;29
mcsched;1206151;474351.816438;29.021488;2;149;0;149
methanosarcina;1206151;0.000000;282.500000;1;58;0;58
mik-250-1-100-1;1206151;-0.000000;0.000000;2;1;0;1
mik-250-20-75-1;1206151;0.000000;0.000000;2;2;0;2
mik-250-20-75-2;1206151;-0.000000;-0.000000;2;2;0;2
mik-250-20-75-3;1206151;-0.000000;-0.000000;2;2;0;2
mik-250-20-75-4;1206151;-0.000000;-0.000000;2;2;0;2
mik-250-20-75-5;1206151;0.000000;-0.000000;2;2;0;2
milo-v12-6-r1-58-1;1206151;422507.582835;147.061179;2;144;0;144
milo-v12-6-r1-75-1;1206151;684446.509887;174.270141;2;162;0;162
milo-v12-6-r2-40-1;1206151;213638.744473;104.126887;2;99;0;99
milo-v13-4-3d-3-0;1206151;23373.122645;0.739975;1;15;0;15
milo-v13-4-3d-4-0;1206151;34049.245605;1.277727;1;32;0;32
mine-166-5;1206151;-552883467.060796;36.684884;5;128;0;128
mine-90-10;1206151;-827656854.061004;55.076435;1;82;0;82
mining;1206151;-885911894.603839;8594.317279;65;70881;1322;72203
minutedispatchstrategy;1206151;3582.138213;101.664381;1441;1929;639;2568
misc07;1206151;1415.000000;8.000000;1;2;0;2
mitre;1206151;114908.998992;168.716846;1;60;0;60
mkc;1206151;-349.170000;-0.000000;3;29;0;29
mkc1;1206151;-569.390000;7.047075;3;31;0;31
mod010;1206151;6532.083333;15.166667;1;14;0;14
modglob;1206151;20786787.016883;-0.000000;2;1;0;1
moj-mining;1206151;-1520532907.350179;566.626558;2;47066;0;47066
momentum1;1206151;121860.460323;47.487111;2;130;0;130
momentum2;1206151;12884.172158;84.534262;3;502;1;503
mrcpspj30-15-5i;1206151;23.000000;69.031311;2;54;0;54
mrcpspj30-17-10i;1206151;25.000000;214.284271;24;110;8;118
mrcpspj30-53-3i;1206151;30.000000;33.607920;2;45;0;45
msc98-ip;1206151;19530897.712302;328.031779;2;1074;1;1075
mspp16;1206151;341.000000;3.000000;1;24008;143;24151
mspsphard01i;1206151;69.000000;45.003105;3;59;1;60
mspsphard03i;1206151;73.000000;92.938259;11;95;6;101
mtest4ma;1206151;60342.000000;0.000000;2;2;0;2
mushroom-best;1206151;0.079076;0.007000;3;283;3;286
mzzv11;1206151;-22076.000000;186.202623;2;289;1;290
mzzv42z;1206151;-20490.000000;179.192264;2;275;1;276
n13-3;1206151;4810470.000000;0.000000;2;2;0;2
n15-3;1206151;71710891.000000;0.000000;2;4705;0;4705
n2seq36f;1206151;71600.000000;-0.000000;3;34;0;34
n2seq36q;1206151;116003.593822;43.392098;3;153;3;156
n3-3;1206151;23704230.000000;0.000000;2;132;0;132
n3700;1206151;1342560.000000;0.000000;2;26;0;26
n3705;1206151;1342540.000000;0.000000;2;47;0;47
n3707;1206151;1301218.000000;0.000000;2;30;0;30
n3709;1206151;1324904.000000;-0.000000;2;26;0;26
n370a;1206151;1353042.000000;-0.000000;2;26;0;26
n370b;1206151;1373791.000000;-0.000000;2;27;0;27
n3div36;1206151;314000.000000;6.227888;3;127;4;131
n3seq24;1206151;198664.580534;43.960251;3;2292;42;2334
n4-3;1206151;12003175.000000;-0.000000;2;57;0;57
n5-3;1206151;10502425.000000;-0.000000;2;15;0;15
n6-3;1206151;10807500.000000;0.000000;2;51;0;51
n7-3;1206151;8409710.000000;0.000000;2;40;0;40
n9-3;1206151;20705025.000000;-0.000000;2;136;0;136
nag;1206151;465.000000;11.321381;3;48;0;48
neos-1061020;1206151;-145860.370608;501.435811;1;888;1;889
neos-1067731;1206151;669053.000000;87.000000;1;635;0;635
neos-1109824;1206151;278.000000;22.000000;1;38;0;38
neos-1112782;1206151;22000000110147.347656;0.000000;2;26;0;26
neos-1112787;1206151;19500000125389.667969;0.000000;2;24;0;24
neos-1122047;1206151;162.000000;0.000000;2;109;0;109
neos-1171448;1206151;-309.000000;5.777778;2;116;0;116
neos-1171692;1206151;-273.000000;4.936782;2;43;0;43
neos-1171737;1206151;-195.000000;9.875000;2;48;0;48
neos-1225589;1206151;5000000000.000000;-0.000000;2;1;0;1
neos-1311124;1206151;-182.000000;5.250000;2;3;0;3
neos-1324574;1206151;36.000000;135.000000;2;33;0;33
neos-1330346;1206151;33.000000;92.391391;2;53;0;53
neos-1337307;1206151;-201272.000000;272.493985;2;54;0;54
neos-1354092;1206151;46.000000;235.398385;2;1031;2;1033
neos-1367061;1206151;31320456.264497;6.250000;2;976;1;977
neos-1396125;1206151;3000.046554;10.228463;2;7;0;7
neos-1420546;1206151;22124.400000;103.140678;1;371;0;371
neos-1420790;1206151;2942.750002;75.132359;1;48;0;48
neos-1423785;1206151;-1773.639422;144.183541;2;349;0;349
neos-1425699;1206151;3175561447.505317;0.344988;1;0;0;0
neos-1426635;1206151;-178.000000;6.235119;2;2;0;2
neos-1426662;1206151;-52.000000;24.768519;2;4;0;4
neos-1429212;1206151;2425.386455;328.355033;1;4413;8;4421
neos-1430701;1206151;-78.000000;5.278895;2;2;0;2
neos-1436709;1206151;-129.000000;5.000000;2;3;0;3
neos-1440225;1206151;36.000000;33.201799;1;69;0;69
neos-1440460;1206151;-180.000000;5.527778;2;2;0;2
neos-1442119;1206151;-182.000000;7.291667;2;3;0;3
neos-1442657;1206151;-156.000000;6.083333;2;3;0;3
neos-1445532;1206151;-14382.000000;4.666667;2;24;0;24
neos-1445738;1206151;-18525.765543;192.856918;1;1037;0;1037
neos-1445743;1206151;-18902.810023;198.050465;1;1150;0;1150
neos-1445765;1206151;-18811.492536;210.050240;1;1113;0;1113
neos-1456979;1206151;154.000000;27.901173;1;49;0;49
neos-1516309;1206151;34769.833333;9.166667;2;28;0;28
neos-1582420;1206151;88.398466;56.499668;5;39;0;39
neos-1593097;1206151;19581.000000;35.532718;1;41;0;41
neos-1599274;1206151;31644.742857;8.000000;2;35;0;35
neos-1601936;1206151;1.000000;155.123290;1;666;0;666
neos-1603965;1206151;619257281.729080;159.273944;3;2217;1;2218
neos-1605061;1206151;6.150735;154.264928;1;2385;0;2385
neos-1605075;1206151;3.214461;180.849737;1;2299;0;2299
neos-1616732;1206151;174.000000;-0.000000;3;62;0;62
neos-1620770;1206151;22.000000;35.000000;2;216;0;216
neos-2294525-abba;1206151;251.550909;6.559286;1;93;0;93
neos-2328163-agri;1206151;27254.625000;58.500000;1;161;0;161
neos-2624317-amur;1206151;0.000000;22.010124;1;2;0;2
neos-2629914-sudost;1206151;39622.000000;15.492958;1;218;0;218
neos-2652786-brda;1206151;0.000000;13.689689;2;2;0;2
neos-2657525-crna;1206151;0.000000;17.653532;2;1;0;1
neos-2669500-cust;1206151;2221.900000;100.250838;1;470;4;474
neos-2746589-doon;1206151;1985.939796;54.551734;1;197;2;199
neos-2974461-ibar;1206151;472952396.770997;3364.000000;2;184436;32;184468
neos-2978193-inde;1206151;-2.418518;7.400000;1;62;0;62
neos-2978205-isar;1206151;-12.415307;29.800000;1;203;0;203
neos-2987202-jeir;1206151;-1847551552.236609;1035.632796;2;61961;1;61962
neos-2987310-joes;1206151;-610797465.676974;19.875000;2;883;0;883
neos-2991472-kalu;1206151;138.000000;19.673706;2;3116;85;3201
neos-3004026-krka;1206151;0.000000;832.000000;1;66;0;66
neos-3009394-lami;1206151;0.642857;216.571429;2;4;0;4
neos-3024952-loue;1206151;25442.000000;116.550000;5;234;0;234
neos-3025225-shelon;1206151;0.077135;318.031391;1;87245;21;87266
neos-3046601-motu;1206151;185.000000;0.023300;2;0;0;0
neos-3046615-murg;1206151;192.000000;0.024900;2;0;0;0
neos-3048764-nadi;1206151;-3883988306.366695;0.000000;1;33;0;33
neos-3065804-namu;1206151;0.000000;0.000000;1;213;0;213
neos-3068746-nene;1206151;77427529.530929;51.698455;2;147;0;147
neos-3072252-nete;1206151;10593526.000000;1.938794;2;1;0;1
neos-3075395-nile;1206151;1127152.765198;9.064729;1;75;0;75
neos-3083784-nive;1206151;0.000000;0.331201;1;5;0;5
neos-3083819-nubu;1206151;6290575.552807;5.598385;1;37;0;37
neos-3116779-oban;1206151;0.000000;0.000000;1;24;0;24
neos-3118745-obra;1206151;291.000000;-0.000000;3;4;0;4
neos-3148108-pahi;1206151;0.000000;0.000000;1;69;1;70
neos-3209462-rhin;1206151;0.000000;47.352227;2;4306;1;4307
neos-3209519-ruhr;1206151;332.850000;25.096416;1;49;0;49
neos-3214367-sovi;1206151;87807.062267;84.903917;1;1821;0;1821
neos-3216931-puriri;1206151;58817.360975;50.614467;1;720;0;720
neos-3226448-wkra;1206151;0.000000;512.043709;1;747;0;747
neos-3237086-abava;1206151;0.000000;56.000000;1;221;2;223
neos-3322547-alsek;1206151;616.000000;115.178534;2;10209;72;10281
neos-3352863-ancoa;1206151;43800.000000;-0.000000;3;689;13;702
neos-3354841-apure;1206151;48560.000000;3.800000;1;2014;22;2036
neos-3355120-tarago;1206151;-19761147.469026;129.215110;1;688;1;689
neos-3355323-arnon;1206151;0.000000;21.818182;4;78;3;81
neos-3372571-onahau;1206151;0.576990;8.695953;2;1215;0;1215
neos-3373491-avoca;1206151;21687686014.015354;20.812587;1;13;0;13
neos-3381206-awhea;1206151;432.000000;61.334767;2;7;0;7
neos-3402294-bobin;1206151;0.000000;50.999394;1;243;2;245
neos-3426085-ticino;1206151;235.000000;41.787470;3;32;0;32
neos-3426132-dieze;1206151;427.000000;103.670666;2;53;1;54
neos-3437289-erdre;1206151;0.000000;0.000000;1;74;1;75
neos-3530903-gauja;1206151;170.000000;33.253136;3;5;0;5
neos-3530905-gaula;1206151;153.000000;29.042208;2;4;0;4
neos-3555904-turama;1206151;-37.915768;1724.960719;3;6060;5;6065
neos-3572885-glina;1206151;0.000000;0.000000;1;81;1;82
neos-3581454-haast;1206151;1969.000000;47.338710;1;80;0;80
neos-3592146-hawea;1206151;7345804.855333;13.281253;1;44;0;44
neos-3594536-henty;1206151;383310.000000;1311.000000;1;71;1;72
neos-3603137-hoteo;1206151;0.000000;34.297619;3;43;1;44
neos-3610040-iskar;1206151;37.165417;2.262083;2;2;0;2
neos-3610051-istra;1206151;48.227558;5.054237;2;5;0;5
neos-3610173-itata;1206151;147.441250;3.692500;2;4;0;4
neos-3611447-jijia;1206151;116.645382;2.294795;2;2;0;2
neos-3611689-kaihu;1206151;138.382063;1.574126;2;2;0;2
neos-3615091-sutlej;1206151;-1506391.117177;161.684320;1;1569;9;1578
neos-3627168-kasai;1206151;1028641.180000;2.678667;2;3;0;3
neos-3634244-kauru;1206151;0.000000;152.720000;1;3714;3;3717
neos-3636886-kereu;1206151;1114.701601;0.001506;2;53;1;54
neos-3660371-kurow;1206151;286.534383;20.430958;1;13;0;13
neos-3661949-lesse;1206151;689000000.000000;0.000000;1;2;0;2
neos-3665875-lesum;1206151;248.325000;40.407566;2;60;0;60
neos-3682128-sandon;1206151;30098104.111687;108.126984;2;75;0;75
neos-3691541-lonja;1206151;-0.061575;9.639780;1;53;0;53
neos-3695882-vesdre;1206151;-145935.214286;39.000000;1;259;1;260
neos-3696678-lyvia;1206151;83.750000;63.000000;1;5;0;5
neos-3699377-maori;1206151;135877.224265;88.955274;2;98;0;98
neos-3703351-marne;1206151;317056.210386;65.821369;2;49;0;49
neos-3740487-motru;1206151;152.145486;76.975427;2;38598;70;38668
neos-3754480-nidda;1206151;-1216923.270104;12.186832;1;2;0;2
neos-3755335-nizao;1206151;50.030157;72.539921;2;482;1;483
neos-3759587-noosa;1206151;48.334468;4.400000;3;308;2;310
neos-3761878-oglio;1206151;422769.022545;66.784000;2;46;0;46
neos-3762025-ognon;1206151;603955.746492;49.449230;2;34;0;34
neos-4165869-wannon;1206151;285.150608;106.929165;2;627;1;628
neos-4230265-orari;1206151;38515515.684909;56.957317;3;2578;1;2579
neos-4260495-otere;1206151;3462.928116;143.832637;3;537;8;545
neos-4264598-oueme;1206151;4719412304.625630;65.571331;2;1956;1;1957
neos-4285819-pedja;1206151;34.451960;101.159938;2;297969;60;298029
neos-4290317-perth;1206151;3613303.634755;0.000000;2;1771;0;1771
neos-4295773-pissa;1206151;0.000000;1644.289474;1;5610;4;5614
neos-4300652-rahue;1206151;0.000000;31.333333;1;644;1;645
neos-4306827-ravan;1206151;-26673.307580;194.882805;2;353;4;357
neos-4321076-ruwer;1206151;1880.558333;39.333333;1;19621;1;19622
neos-4322846-ryton;1206151;0.419848;24.872919;1;605;5;610
neos-4332801-seret;1206151;233683.594384;172.168422;3;262;5;267
neos-4332810-sesia;1206151;-23062.998566;161.354975;3;251;5;256
neos-4333464-siret;1206151;24.688318;0.121324;2;8;0;8
neos-4333596-skien;1206151;-14653654.846569;0.746303;1;2;0;2
neos-4335793-snake;1206151;0.123684;141.753072;2;1290;1;1291
neos-4338804-snowy;1206151;1447.000000;21.239000;3;3;0;3
neos-4343293-stony;1206151;52.758728;0.200000;2;49;0;49
neos-4355351-swalm;1206151;33.854869;0.094819;2;151;3;154
neos-4358725-tagus;1206151;1889548.577948;203.435939;2;671;0;671
neos-4359986-taipa;1206151;0.395578;39.118149;1;851;1;852
neos-4360552-sangro;1206151;-29.500000;576.481637;1;8714;1;8715
neos-4387871-tavua;1206151;36.445048;0.200000;2;42;0;42
neos-4391920-timok;1206151;0.000378;34.957374;1;5853;5;5858
neos-4393408-tinui;1206151;340.267489;0.200000;2;41;0;41
neos-4408804-prosna;1206151;914.483516;71.708791;1;3393;1;3394
neos-4409277-trave;1206151;0.000000;350.162065;1;1855;1;1856
neos-4413714-turia;1206151;43.474651;371.333441;1;1873;10;1883
neos-4532248-waihi;1206151;0.370420;27.004111;1;3964;4;3968
neos-4533806-waima;1206151;3063.318841;49.500000;1;938;4;942
neos-4545615-waita;1206151;3606.594190;54.131913;1;18642;41;18683
neos-4555749-wards;1206151;3026.812121;34.998623;1;897;5;902
neos-4562542-watut;1206151;3743.304348;42.380485;1;2931;8;2939
neos-4647027-thurso;1206151;26911.641616;130.575703;1;2238;0;2238
neos-4647030-tutaki;1206151;26911.641616;131.360812;1;2896;0;2896
neos-4647032-veleka;1206151;26587.908699;174.943874;1;3436;0;3436
neos-4650160-yukon;1206151;-22633.302692;150.257047;1;4;0;4
neos-4722843-widden;1206151;63671.455263;748.515195;3;334;7;341
neos-4724674-aorere;1206151;3955.706101;89.034940;3;343;6;349
neos-4736745-arroux;1206151;262263446.114579;4.100609;2;35;0;35
neos-4738912-atrato;1206151;323678468.688703;3.843750;2;30;0;30
neos-4754521-awarau;1206151;0.000000;0.000000;1;1084;6;1090
neos-4760493-puerua;1206151;1908.243695;237.071976;1;33149;2;33151
neos-476283;1206151;406.244708;13.663873;1;6411;0;6411
neos-4763324-toguru;1206151;1120.986062;232.945926;1;31963;2;31965
neos-4797081-pakoka;1206151;0.000000;995.738455;1;6380;2;6382
neos-4805882-barwon;1206151;22058.983698;108.041076;3;206;1;207
neos-480878;1206151;515.138796;4.583278;2;18;0;18
neos-4954274-beardy;1206151;18659.208282;287.749893;2;974;2;976
neos-4954672-berkel;1206151;3491016.775148;2.808176;2;2;0;2
neos-4966258-blicks;1206151;366.090909;30.789773;2;1107;1;1108
neos-4971100-bodrog;1206151;-0.000000;0.000000;1;52;0;52
neos-4972437-bojana;1206151;357.086296;28.765194;2;6965;2;6967
neos-4972461-bolong;1206151;466.511858;34.763016;2;7722;2;7724
neos-4976951-bunnoo;1206151;377.416466;27.913354;2;6134;2;6136
neos-4984115-canche;1206151;-9947088.084138;0.363560;1;12;0;12
neos-498623;1206151;16.283333;46.801587;1;97;0;97
neos-5013590-toitoi;1206151;1064.447092;169.000000;1;14598;1;14599
neos-5018451-chiese;1206151;-148612315.605332;10.652915;1;1321;0;1321
neos-503737;1206151;50.000000;47.918146;1;31;0;31
neos-5041822-cockle;1206151;5701464.927099;174.422554;3;828;3;831
neos-5044663-wairoa;1206151;4653100.000000;573.309583;1;16436;1;16437
neos-5045105-creuse;1206151;19.066671;17.680786;1;59;0;59
neos-5049753-cuanza;1206151;464.000000;46.400000;1;1824;2;1826
neos-5051588-culgoa;1206151;128.750000;30.632366;1;96;0;96
neos-5052403-cygnet;1206151;219.007927;94.805311;8;36652;169;36821
neos-506422;1206151;0.000000;7.000000;1;137;0;137
neos-506428;1206151;145945.000000;96.000000;1;1092;3;1095
neos-5075914-elvire;1206151;305.493099;56.895754;2;95;0;95
neos-5076235-embley;1206151;1930.000000;0.112088;2;499;0;499
neos-5078479-escaut;1206151;7438.416728;53.893699;2;122;0;122
neos-5079731-flyers;1206151;2004.000000;1.153846;2;467;0;467
neos-5083528-gimone;1206151;0.000000;17.250000;1;212;3;215
neos-5093327-huahum;1206151;3934.000000;1.858333;2;578;0;578
neos-5100895-inster;1206151;2084.000000;3.428571;2;383;0;383
neos-5102383-irwell;1206151;1740.000000;2.593407;2;542;0;542
neos-5104907-jarama;1206151;648.590198;48.358189;2;7002;3;7005
neos-5106984-jizera;1206151;721.000000;2.257143;2;2789;3;2792
neos-5107597-kakapo;1206151;0.000000;0.591250;2;34;0;34
neos-5108386-kalang;1206151;621.655661;37.918891;2;15001;4;15005
neos-5114902-kasavu;1206151;518.000000;86.333333;1;7701;5;7706
neos-5115478-kaveri;1206151;0.000000;0.529375;2;39;0;39
neos-5116085-kenana;1206151;452.000000;75.333333;1;5366;3;5369
neos-5118834-korana;1206151;583.521384;84.165894;2;12691;4;12695
neos-5118851-kowhai;1206151;1134.000000;4.250000;2;3489;5;3494
neos-5123665-limmat;1206151;654.150497;48.317256;2;19164;5;19169
neos-5125849-lopori;1206151;0.000000;5.984639;1;37;0;37
neos-5129192-manaia;1206151;0.000000;4.000000;1;3296;11;3307
neos-5138690-middle;1206151;609.154239;77.027095;2;17786;5;17791
neos-5140963-mincio;1206151;8877.000000;2.142857;1;1;0;1
neos-5149806-wieprz;1206151;45.000000;7.634481;3;379;9;388
neos-5151569-mologa;1206151;686014018.994231;27.888300;2;2567;2;2569
neos-5178119-nalagi;1206151;8.569859;24.379086;2;83;1;84
neos-5182409-nasivi;1206151;0.000000;19.712425;1;7;0;7
neos-5188808-nattai;1206151;0.000000;13.355766;1;514;0;514
neos-5189128-totara;1206151;330131.390743;21.863581;1;916;2;918
neos-5192052-neckar;1206151;-11980000.000000;0.400000;2;0;0;0
neos-5193246-nerang;1206151;0.000000;427.000890;1;239;0;239
neos-5195221-niemur;1206151;0.000000;364.863502;1;306;0;306
neos-5196530-nuhaka;1206151;0.000000;406.675411;1;335;0;335
neos-520729;1206151;-1389625.000000;9.185238;1;472;0;472
neos-5221106-oparau;1206151;0.000000;33.949758;1;550;1;551
neos-525149;1206151;60.000000;40.416667;1;33;0;33
neos-5260764-orauea;1206151;58748.022532;8.725559;1;67;0;67
neos-5261882-treska;1206151;26047.998000;6.157765;1;6;0;6
neos-5266653-tugela;1206151;21659.678723;20.155553;1;124;1;125
neos-555001;1206151;962625.000000;32.414286;1;8;0;8
neos-555343;1206151;1346700.000000;157.193056;4;9;0;9
neos-555424;1206151;1286800.000000;144.027778;1;41;0;41
neos-555884;1206151;1112400.000000;165.150000;1;34;0;34
neos-565672;1206151;55015.268433;57.351362;4;13257;19;13276
neos-574665;1206151;5932913.752734;8.390264;3;4;0;4
neos-578379;1206151;0.000000;99.171812;1;2023;1;2024
neos-585192;1206151;384.328979;0.433130;2;11;0;11
neos-585467;1206151;347.224531;0.316538;2;8;0;8
neos-595904;1206151;61213.471080;16.893904;2;73;0;73
neos-619167;1206151;1.481241;34.850492;1;110;0;110
neos-631517;1206151;6999347.296879;55.400180;2;9;0;9
neos-631710;1206151;286.000000;225.464535;2;1038;19;1057
neos-633273;1206151;6996841097.997801;0.000000;1;202;0;202
neos-662469;1206151;184342.980720;94.063832;1;495;1;496
neos-686190;1206151;5134.813830;17.515957;1;41;0;41
neos-691058;1206151;263.400000;89.445421;1;133;0;133
neos-693347;1206151;234.000000;78.661138;1;765;0;765
neos-738098;1206151;-1099.000000;195.489493;1;273;0;273
neos-777800;1206151;-80.000000;74.416196;1;60;0;60
neos-780889;1206151;3421500.000000;0.000000;1;352;6;358
neos-787933;1206151;30.000000;0.000000;1;1;0;1
neos-799711;1206151;-11228065.153797;78.369325;1;931;0;931
neos-799716;1206151;4932670.661692;20.807498;1;79;0;79
neos-807639;1206151;332.924117;12.512286;1;7;0;7
neos-820879;1206151;24874.267857;63.030000;1;80;0;80
neos-824661;1206151;55.000000;94.965217;2;255;1;256
neos-824695;1206151;43.000000;61.571429;2;106;0;106
neos-826224;1206151;124.000000;43.333333;2;224;2;226
neos-826650;1206151;32.000000;154.916667;2;48;0;48
neos-826694;1206151;72.000000;221.851190;2;128;1;129
neos-826812;1206151;69.011000;175.561360;3;123;1;124
neos-826841;1206151;32.008200;127.466667;2;42;0;42
neos-827015;1206151;2.098071;332.649497;1;1915;3;1918
neos-827175;1206151;115.001520;111.833333;2;143;1;144
neos-829552;1206151;2.098071;248.920991;1;1578;1;1579
neos-831188;1206151;1.767720;87.466667;1;51;0;51
neos-847302;1206151;0.000000;46.902472;1;58;0;58
neos-848198;1206151;168977.000000;-0.000000;2;135;0;135
neos-848589;1206151;0.000000;1.000000;1;1127;1;1128
neos-849702;1206151;0.000000;87.450805;1;18;0;18
neos-850681;1206151;2087.000000;50.000000;1;111;0;111
neos-860300;1206151;2035.362225;9.000000;1;40;0;40
neos-872648;1206151;52.671483;0.000000;2;1016;7;1023
neos-873061;1206151;135.208828;0.000000;2;1300;7;1307
neos-876808;1206151;169615.062608;275.400000;2;2634;2;2636
neos-885086;1206151;-243.000000;18.235808;2;201;0;201
neos-885524;1206151;12397.479000;5.525486;3;67;3;70
neos-911880;1206151;23.260000;16.155343;1;2;0;2
neos-911970;1206151;23.260000;14.456206;1;2;0;2
neos-913984;1206151;1000.000000;32.223499;1;169;3;172
neos-914441;1206151;5660364.283770;102.051261;1;2166;0;2166
neos-916792;1206151;26.283217;17.068306;2;110;0;110
neos-932721;1206151;513000.000000;-0.000000;2;58;0;58
neos-932816;1206151;513000.000000;0.000000;2;118;1;119
neos-933562;1206151;0.000000;82.687196;1;32;0;32
neos-933638;1206151;474007.000000;0.000000;2;176;1;177
neos-933966;1206151;412038.000000;0.000000;2;125;1;126
neos-934278;1206151;456006.000000;0.000000;2;309;1;310
neos-935234;1206151;436011.000000;0.000000;2;292;1;293
neos-935627;1206151;23250.000000;0.000000;2;315;1;316
neos-935769;1206151;23520.000000;-0.000000;2;307;1;308
neos-937511;1206151;52640.000000;-0.000000;2;396;1;397
neos-937815;1206151;53510.000000;-0.000000;2;420;1;421
neos-941262;1206151;51733.000000;-0.000000;2;423;1;424
neos-941313;1206151;9361.000000;209.984127;1;468;5;473
neos-942830;1206151;12.000000;64.350128;2;25;0;25
neos-948126;1206151;52602.000000;-0.000000;2;329;1;330
neos-948346;1206151;-183.450878;30.429691;5;447;17;464
neos-950242;1206151;2.000000;42.000000;2;102;1;103
neos-953928;1206151;-8.906667;12.942467;4;135;4;139
neos-954925;1206151;-160.787389;33.890744;4;399;15;414
neos-956971;1206151;-106.788318;33.852264;4;518;17;535
neos-957143;1206151;-185.847699;34.060881;5;561;14;575
neos-957323;1206151;-218.785116;18.500000;3;277;9;286
neos-957389;1206151;1.500000;23.329101;1;73;1;74
neos-960392;1206151;-238.000000;301.558442;1;246;3;249
neos-983171;1206151;52403.000000;0.000000;2;344;1;345
neos-984165;1206151;51812.000000;0.000000;2;414;1;415
neos13;1206151;-126.178378;42.160092;2;164;0;164
neos15;1206151;143201.242910;0.000000;2;1;0;1
neos16;1206151;429.000000;13.714286;3;4;0;4
neos17;1206151;0.222688;0.000000;2;7;0;7
neos18;1206151;12.000000;37.833333;5;106;0;106
neos2;1206151;-4407.097239;5.158588;1;4;0;4
neos22;1206151;790282.857143;12.207143;2;36;0;36
neos5;1206151;17.250000;0.000000;2;1;0;1
neos6;1206151;114.038055;32.275044;6;262;7;269
neos8;1206151;-3309.500000;20.750000;3;26;0;26
neos808444;1206151;0.000000;198.728752;1;205;1;206
neos9;1206151;780.000000;44.250000;1;281;0;281
net12;1206151;47.514236;134.516319;3;1127;1;1128
netdiversion;1206151;454.000000;754.600000;3;7454;15;7469
newdano;1206151;11.724138;8.447296;1;2;0;2
nexp-150-20-1-5;1206151;74.000000;-0.000000;3;35;0;35
nexp-150-20-8-5;1206151;552.000000;-0.000000;2;69;1;70
nexp-50-20-1-1;1206151;35.000000;-0.000000;2;1;0;1
nexp-50-20-4-2;1206151;120.000000;0.000000;2;2;0;2
nh97_potential;1206151;1461.000000;72.750000;2;6;0;6
nh97_tension;1206151;1429.000000;76.466667;2;2;0;2
nj1;1206151;0.000000;607.000000;1;469;1;470
nj2;1206151;0.000000;607.000000;1;699;1;700
nj3;1206151;0.000000;607.000000;1;1773;1;1774
nobel-eu-DBE;1206151;7662120.000000;0.000000;2;94;0;94
noswot;1206151;-39.920111;4.557455;3;1;0;1
ns1111636;1206151;96.250000;17.588542;1;310;1;311
ns1116954;1206151;0.000000;154.227320;1;775;1;776
ns1208400;1206151;0.000000;92.146914;1;35;0;35
ns1430538;1206151;73.621609;10.751709;1;400;0;400
ns1456591;1206151;361.939022;19.000000;1;110;0;110
ns1606230;1206151;13.225000;179.621722;1;2091;0;2091
ns1631475;1206151;94800.000000;643.196596;2;1201;2;1203
ns1679495;1206151;3355407.151677;106.229642;2;47181;9;47190
ns1685374;1206151;-51.800913;96.218654;1;2236;1;2237
ns1688347;1206151;2.259259;74.205225;1;363;0;363
ns1690781;1206151;-1022.227789;60.056795;2;84;0;84
ns1696083;1206151;2.038462;48.811865;1;477;1;478
ns1758913;1206151;-1473.311978;85.635340;1;8045;4;8049
ns1760995;1206151;-1349.487943;142.000000;1;14582;7;14589
ns1778858;1206151;-22635740.000000;227.465047;2;282;0;282
ns1828997;1206151;0.000000;75.000000;1;1112;1;1113
ns1830653;1206151;7083.000000;59.569632;1;84;0;84
ns1849932;1206151;546.000000;6.131653;1;1041;5;1046
ns1853823;1206151;1172000.000000;1345.731857;2;42875;24;42899
ns1854840;1206151;1664000.000000;1124.615817;2;8657;13;8670
ns1856153;1206151;0.000000;203.675428;2;180;1;181
ns1904248;1206151;0.000000;476.666667;3;2482;7;2489
ns1905797;1206151;11.750980;32.426504;1;216;1;217
ns1905800;1206151;6.436600;26.487503;1;47;0;47
ns1952667;1206151;0.000000;9.316422;1;188;1;189
ns2017839;1206151;77026841466348.468750;1.620352;2;4957;0;4957
ns2034125;1206151;24740.000000;429.218830;2;2710;0;2710
ns2071214;1206151;0.000000;53.955240;1;82;0;82
ns2081729;1206151;4.600000;0.174500;2;2;0;2
ns2122698;1206151;62785.622771;196.156523;1;369;1;370
ns2124243;1206151;53998.333333;186.527778;1;271;1;272
ns2137859;1206151;24629.000000;56.954851;1;99;0;99
ns4-pr3;1206151;711323.000000;0.000000;2;132;0;132
ns4-pr6;1206151;395464.500000;0.000000;2;33;0;33
ns4-pr9;1206151;549125.000000;0.000000;2;74;0;74
ns894236;1206151;18.000000;109.321441;2;209;0;209
ns894244;1206151;16.000000;172.305570;2;507;1;508
ns894786;1206151;14.000000;98.226662;2;507;2;509
ns894788;1206151;7.000000;55.131615;2;90;0;90
ns903616;1206151;22.000000;175.549209;2;486;1;487
nsa;1206151;91.855632;7.418401;2;7;0;7
nsr8k;1206151;17500809.511815;639.470648;1;8920;3;8923
nsrand-ipx;1206151;68640.000000;0.000000;3;53;1;54
nu120-pr12;1206151;197775.000000;4.800000;2;44;0;44
nu120-pr3;1206151;511253.750000;28.016727;2;105;0;105
nu120-pr9;1206151;334880.000000;15.750000;2;75;0;75
nu25-pr12;1206151;297882.500000;4.233333;2;43;0;43
nu4-pr9;1206151;549125.000000;12.513333;2;72;0;72
nu60-pr9;1206151;386150.000000;12.150000;2;73;0;73
nucorsav;1206151;29.046100;74.292914;1;74035;133;74168
nursesched-medium-hint03;1206151;33.468485;463.947617;1;1100;3;1103
nursesched-medium04;1206151;452.000000;371.763072;2;805;6;811
nursesched-sprint-hidden09;1206151;516.944444;178.989683;2;327;2;329
nursesched-sprint-late03;1206151;34.254806;182.557279;1;337;1;338
nursesched-sprint02;1206151;154.416667;130.963542;2;203;2;205
nw04;1206151;16310.666667;2.000000;1;185;2;187
ofi;1206151;6135598681.449045;1321.867570;196;3386;97;3483
ofi2;1206151;6128453035.160096;1604.443623;184;6112;145;6257
oocsp-racks030e6cci;1206151;0.000000;547.447664;15;173;10;183
opm2-z10-s2;1206151;-21344.000000;0.000000;5;7301;7;7308
opm2-z10-s4;1206151;-20011.000000;-0.000000;5;7795;7;7802
opm2-z11-s8;1206151;-24077.000000;0.000000;5;10944;8;10952
opm2-z12-s14;1206151;-38546.000000;-0.000000;5;22974;13;22987
opm2-z12-s7;1206151;-33919.000000;-0.000000;5;25287;13;25300
opm2-z12-s8;1206151;-35083.000000;0.000000;6;27254;15;27269
opm2-z6-s1;1206151;-2356.000000;-0.000000;3;277;0;277
opm2-z7-s2;1206151;-7132.000000;-0.000000;4;716;2;718
opm2-z7-s8;1206151;-6856.000000;-0.000000;4;608;1;609
opm2-z8-s0;1206151;-8004.000000;0.000000;3;1430;2;1432
opt1217;1206151;-20.021390;10.060606;1;2;0;2
osorio-cta;1206151;0.000000;0.013388;1;46;0;46
p0201;1206151;7155.000000;10.900000;1;1;0;1
p100x588b;1206151;58977.000000;0.000000;2;1;0;1
p200x1188c;1206151;15747.000000;0.000000;2;2;0;2
p2756;1206151;2706.000000;24.070313;2;4;0;4
p500x2988;1206151;72594.000000;0.000000;2;29;0;29
p500x2988c;1206151;17212.000000;-0.000000;2;29;0;29
p500x2988d;1206151;6.000000;-0.000000;2;27;0;27
p6b;1206151;-53.000000;0.000000;3;50;0;50
p80x400b;1206151;45896.000000;-0.000000;2;1;0;1
pb-fit2d;1206151;-22363.768555;843.273209;1;6651;11;6662
pb-gfrd-pnc;1206151;8321.694589;42.993642;1;106;0;106
pb-grow22;1206151;-449654.852582;121.611433;1;411;0;411
pb-market-split8-70-4;1206151;0.000000;1.843507;1;0;0;0
pb-simp-nonunif;1206151;9.500000;280.033333;5;2402;11;2413
peg-solitaire-a3;1206151;1.000000;265.145532;1;325;0;325
pg;1206151;-11098.657382;17.215049;2;4;0;4
pg5_34;1206151;-16012.248077;18.476238;2;5;0;5
physiciansched3-3;1206151;2590923.193775;699.205074;3;16186;4;16190
physiciansched3-4;1206151;1460000.029192;507.419205;3;18914;3;18917
physiciansched5-3;1206151;20464.000000;133.462963;2;820;1;821
physiciansched6-1;1206151;10067.500000;253.698611;3;691;2;693
physiciansched6-2;1206151;47675.160783;435.646407;4;372;1;373
pigeon-08;1206151;-8000.000000;4.485714;1;2;0;2
pigeon-10;1206151;-10000.000000;8.022222;1;2;0;2
pigeon-11;1206151;-11000.000000;9.020000;1;3;0;3
pigeon-12;1206151;-12000.000000;10.018182;1;4;0;4
pigeon-13;1206151;-13000.000000;11.016667;1;3;0;3
pigeon-16;1206151;-16000.000000;34.984242;1;5;0;5
pigeon-19;1206151;-19000.000000;17.011111;1;6;0;6
pigeon-20;1206151;-20000.000000;26.250718;1;6;0;6
piperout-03;1206151;69590.490975;240.307638;7;299;2;301
piperout-08;1206151;99228.924471;298.804974;9;296;2;298
piperout-27;1206151;7146.876623;517.233607;684;305;236;541
piperout-d20;1206151;25601.416667;437.748324;2;668;1;669
piperout-d27;1206151;7199.340391;682.880995;2;866;1;867
pk1;1206151;0.000000;2.794444;1;0;0;0
polygonpack3-15;1206151;-114051612.169520;43.644898;3;981;5;986
polygonpack4-10;1206151;-93676953.470100;20.424622;3;370;2;372
polygonpack4-15;1206151;-114052801.790860;41.117829;3;1178;6;1184
polygonpack4-7;1206151;-75324958.874200;9.351513;3;182;1;183
polygonpack5-15;1206151;-66029981.130960;31.476023;3;1351;5;1356
pp08a;1206151;15000.000000;-0.000000;2;0;0;0
pp08aCUTS;1206151;16630.402442;0.000000;2;2;0;2
probportfolio;1206151;7.321966;24.067729;1;3;0;3
prod1;1206151;-55.000000;3.767946;2;2;0;2
prod2;1206151;-59.000000;4.566580;2;5;0;5
proteindesign121hz512p19;1206151;3197.772133;54.952462;1;5128;64;5192
proteindesign121hz512p9;1206151;1423.904449;59.959446;1;198;3;201
proteindesign121pgb11p9;1206151;1173.710433;48.788284;1;170;3;173
proteindesign122trx11p8;1206151;1720.461105;44.719330;1;207;3;210
protfold;1206151;0.000000;34.634891;2;32;0;32
pw-myciel4;1206151;4.000000;94.775204;4;7;0;7
pythago7824;1206151;0.000000;580.777778;6;769;2;771
pythago7825;1206151;0.000000;586.777778;8;835;3;838
qap10;1206151;332.566228;55.000000;1;421;0;421
qiu;1206151;1805.177158;0.000000;2;6;0;6
qnet1;1206151;89045.940000;7.221868;2;18;0;18
qnet1_o;1206151;93221.720000;0.000000;2;5;0;5
queens-30;1206151;-30.000000;0.000000;3;201;2;203
r4l4-02-tree-bounds-50;1206151;512370030.000000;648.050000;3;44;0;44
r50x360;1206151;2016.000000;-0.000000;2;1;0;1
r80x800;1206151;5520.000000;-0.000000;2;2;0;2
radiationm18-12-05;1206151;17561.353680;193.062229;2;68;0;68
radiationm40-10-02;1206151;155317.684921;698.420363;2;280;2;282
rail01;1206151;-90.767086;1608.458333;1;12973;3;12976
rail02;1206151;-206.092110;2179.300000;1;117402;8;117410
rail03;1206151;-919.222126;7606.865972;1;184740;27;184767
rail507;1206151;207.000000;-0.000000;3;239;4;243
railway_8_1_0;1206151;397.000000;46.034177;3;6;0;6
ramos3;1206151;440.000000;-0.000000;3;1389;0;1389
ran12x21;1206151;4080.000000;0.000000;2;0;0;0
ran13x13;1206151;3521.000000;0.000000;2;0;0;0
ran14x18-disj-8;1206151;12170.996653;0.000000;2;17;0;17
ran14x18;1206151;4265.000000;0.000000;2;0;0;0
ran16x16;1206151;4333.000000;0.000000;2;0;0;0
rd-rplusc-21;1206151;100.000000;3.709516;1;343;0;343
reblock115;1206151;-37981832.798944;238.100873;1;340;0;340
reblock166;1206151;-640892721.079106;86.859092;6;400;1;401
reblock354;1206151;-39586262.751951;411.245436;1;1040;0;1040
reblock420;1206151;-558825455.521724;213.947318;7;1816;3;1819
reblock67;1206151;-36575497.117631;131.415935;1;41;0;41
rfds-4-days;1206151;-1158940.978167;62.166667;1;17409;9;17418
rlp1;1206151;13.244444;9.961905;1;1;0;1
rmatr100-p10;1206151;360.593308;9.692735;1;238;0;238
rmatr100-p5;1206151;762.040054;5.000000;1;403;0;403
rmatr200-p10;1206151;1550.620783;10.000000;1;11115;0;11115
rmatr200-p20;1206151;688.357943;19.982266;1;3272;0;3272
rmatr200-p5;1206151;3283.653831;5.000000;1;12522;0;12522
rmine10;1206151;-1926.863820;886.708002;1;3232;1;3233
rmine11;1206151;-2522.047107;1304.350285;1;8476;1;8477
rmine13;1206151;-3504.619914;1108.274293;2;24496;5;24501
rmine14;1206151;-4310.694704;2228.265999;1;112104;3;112107
rmine15;1206151;-5042.482963;4267.046917;1;236796;4;236800
rmine6;1206151;-462.305727;106.725097;1;121;0;121
rocI-3-11;1206151;-110705.000000;55.887636;16;11;0;11
rocI-4-11;1206151;-11110705.000000;66.745360;17;38;1;39
rocII-10-11;1206151;-11.946851;198.052596;2;878;2;880
rocII-4-11;1206151;-11.867128;49.198977;2;53;0;53
rocII-5-11;1206151;-11.893702;59.199453;2;72;0;72
rocII-7-11;1206151;-11.924073;119.849935;1;185;0;185
rocII-8-11;1206151;-11.933564;159.333601;2;240;1;241
rocII-9-11;1206151;-11.940946;178.324932;2;329;2;331
rococoB10-011000;1206151;51207.000000;10.950589;5;118;0;118
rococoC10-001000;1206151;23730.000000;0.000000;6;25;0;25
rococoC11-010100;1206151;143170.000000;22.416868;2;156;0;156
rococoC11-011100;1206151;139407.000000;14.937663;2;115;0;115
rococoC12-010001;1206151;117774.000000;9.895179;2;191;1;192
rococoC12-111000;1206151;27337.357381;31.147270;1;245;0;245
roi2alpha3n4;1206151;-78.888089;8.000000;2;718;9;727
roi5alpha10n8;1206151;-84.342241;16.000000;2;1891;23;1914
roll3000;1206151;11939.645814;52.881579;2;22;0;22
rout;1206151;981.864286;10.233819;1;2;0;2
rpp22falsei;1206151;0.000000;74.210179;3;63;1;64
rvb-sub;1206151;11.206514;4.857143;1;719;4;723
s100;1206151;-0.170525;28.899744;1;19045;15;19060
s1234;1206151;0.361925;1.571653;2;808;0;808
s250r10;1206151;-0.168732;59.939334;2;7945;24;7969
s55;1206151;-22.151773;60.323192;1;1509;3;1512
satellites1-25;1206151;-20.000000;112.132767;1;569;0;569
satellites2-25;1206151;-29.000000;379.188850;1;30642;2;30644
satellites2-40;1206151;-29.000000;350.462240;1;25635;2;25637
satellites2-60-fs;1206151;-23.972601;437.642681;2;4688;2;4690
satellites2-60;1206151;-29.000000;350.462240;1;25470;2;25472
satellites3-25;1206151;-38.000000;748.576477;1;261958;4;261962
satellites3-40-fs;1206151;-32.664860;836.453067;2;27110;6;27116
satellites3-40;1206151;-38.000000;764.579864;1;215485;4;215489
savsched1;1206151;8400.875000;-0.000000;3;63347;42;63389
scpj4scip;1206151;183.000000;-0.000000;3;1290;25;1315
scpk4;1206151;389.000000;0.000000;3;2642;24;2666
scpl4;1206151;360.000000;-0.000000;3;4740;51;4791
scpm1;1206151;774.000000;0.000000;3;44428;131;44559
scpn2;1206151;741.000000;-0.000000;3;69969;243;70212
sct1;1206151;-186.838854;85.284884;2;1093;1;1094
sct2;1206151;-86.372659;17.837708;2;59;0;59
sct31;1206151;186.783515;24.423168;2;224;0;224
sct32;1206151;51.266438;45.043874;2;508;1;509
sct5;1206151;-227.029312;28.919325;2;468;2;470
seqsolve1;1206151;4770.293168;265.188388;24;5489;131;5620
seqsolve2short4288;1206151;20.396875;318.804378;4;6642;23;6665
seqsolve3short4288excess384;1206151;-43472.799518;407.473201;8;10316;47;10363
set1ch;1206151;107691.500000;-0.000000;2;1;0;1
set3-09;1206151;1263.077974;13.704533;2;10;0;10
set3-10;1206151;788.890655;13.953500;2;9;0;9
set3-15;1206151;8364.040745;17.366709;2;16;0;16
set3-16;1206151;9916.808562;19.040932;2;14;0;14
set3-20;1206151;10347.381087;16.724301;2;11;0;11
seymour-disj-10;1206151;331.000001;-0.000000;4;1754;2;1756
seymour;1206151;452.000000;0.000000;3;224;0;224
seymour1;1206151;419.891318;-0.000000;3;212;0;212
shiftreg1-4;1206151;131.656032;170.412698;1;39;0;39
shiftreg2-7;1206151;206.733052;112.525005;1;68;0;68
shiftreg5-1;1206151;520.839888;531.003874;1;316;0;316
shipsched;1206151;-0.000000;8.077417;4;82;0;82
shipschedule3shipsi;1206151;-265650.000000;353.645640;12;55;2;57
shipschedule6shipsmixi;1206151;-301650.000000;713.080672;9;88;3;91
shipschedule8shipsmixuci;1206151;-401100.000000;523.185400;11;89;5;94
shs1014;1206151;22137.410363;320.475000;1;36790;19;36809
shs1042;1206151;10404.662711;568.781970;1;34531;20;34551
siena1;1206151;10163179.229002;146.859338;1;1327;2;1329
sing11;1206151;18640171.224643;243.132649;1;7225;4;7229
sing161;1206151;19071259.113926;685.480441;1;71818;20;71838
sing17;1206151;35483848.876513;472.456436;1;26773;11;26784
sing2;1206151;17150914.716940;256.737979;1;1811;1;1812
sing245;1206151;25024015.754083;395.965975;1;12112;6;12118
sing326;1206151;7717674.801189;172.968798;1;2506;2;2508
sing359;1206151;22534478.962498;889.129081;1;81572;18;81590
sing44;1206151;8102513.219400;139.469372;1;2931;2;2933
sing5;1206151;18418516.013137;236.754039;1;2823;3;2826
snip10x10-35r1budget17;1206151;30.000000;3.224794;2;1344;0;1344
snp-02-004-104;1206151;567161691.779774;7.604965;5;5458;1;5459
snp-04-052-052;1206151;746313354.490274;733.799382;6;4716;3;4719
snp-06-004-052;1206151;1831976376.522612;31.156229;2;8127;0;8127
snp-10-004-052;1206151;5961214167.823297;42.379535;6;20403;2;20405
snp-10-052-052;1206151;6009206679.336597;1683.882989;6;21838;8;21846
sorrell3;1206151;-13.000000;-0.000000;3;380;0;380
sorrell4;1206151;-18.000000;-0.000000;3;1010;2;1012
sorrell7;1206151;-141.000000;0.000000;3;14502;0;14502
sorrell8;1206151;-269.000000;0.000000;3;192;0;192
sp150x300d;1206151;71.000000;0.000000;2;0;0;0
sp97ar;1206151;815120355.519999;2.342794;4;399;6;405
sp97ic;1206151;578703486.755542;0.975543;3;349;4;353
sp98ar;1206151;648426163.072905;1.440725;4;557;7;564
sp98ic;1206151;605964163.117924;3.283712;5;337;6;343
sp98ir;1206151;271833089.651983;6.757325;5;48;1;49
splice1k1;1206151;-3.068619;1.426914;2;32514;18;32532
splice1k1i;1206151;-1646.777979;134.969052;1;14559;3;14562
square23;1206151;8.333333;12.444444;1;100;1;101
square31;1206151;8.500000;13.750000;1;595;5;600
square37;1206151;8.666667;13.666667;1;1311;10;1321
square41;1206151;8.839612;15.068891;1;2357;15;2372
square47;1206151;8.755814;15.976744;1;5991;28;6019
stoch-vrpvrp-s5v2c8vrp-v2c8i;1206151;0.000000;90.875770;2;17;0;17
stockholm;1206151;174.000000;-0.000000;2;398;0;398
stp3d;1206151;564.338735;444.506671;2;22867;12;22879
sts405;1206151;357.000000;0.000000;2;512;1;513
sts729;1206151;665.000000;0.000000;2;3254;5;3259
supportcase1;1206151;20078.000000;0.020832;2;241;4;245
supportcase10;1206151;3.383924;971.624635;2;9851;4;9855
supportcase11;1206151;-14.281996;0.000000;1;3;0;3
supportcase12;1206151;-7559.533054;69.511088;1;1773;0;1773
supportcase14;1206151;272.000000;7.333333;1;1;0;1
supportcase16;1206151;272.000000;7.333333;1;1;0;1
supportcase17;1206151;0.000000;32.284011;2;5;0;5
supportcase18;1206151;87.000000;9.141806;2;44;1;45
supportcase19;1206151;12677206.000000;370.390975;1;25866;79;25945
supportcase2;1206151;0.000000;4.750000;1;8368;48;8416
supportcase20;1206151;108889.000000;0.000000;2;17;0;17
supportcase23;1206151;-12952.000000;617.629502;1;1603;0;1603
supportcase25;1206151;0.036932;10.829622;1;100;0;100
supportcase26;1206151;1288.102161;0.009948;2;1;0;1
supportcase27i;1206151;0.000000;93.694826;2;7;0;7
supportcase3;1206151;0.000000;403.282880;3;205;0;205
supportcase30;1206151;0.000000;102.857020;1;57;0;57
supportcase31;1206151;79524.180000;4.000000;2;1804;53;1857
supportcase33;1206151;-465.000000;28.172772;2;100;0;100
supportcase34;1206151;72.664116;196.140621;1;450;1;451
supportcase35;1206151;174371.000000;0.000000;2;92;0;92
supportcase37;1206151;-5803.552159;23.221484;2;970;0;970
supportcase39;1206151;-1062330.369524;22.808785;5;87;7;94
supportcase4;1206151;0.000000;202.915359;3;156;0;156
supportcase40;1206151;22536.483379;19.000000;1;247;0;247
supportcase41;1206151;28.000000;36.047859;2;607;0;607
supportcase42;1206151;7.343539;48.081295;1;1643;2;1645
supportcase43;1206151;0.000000;48.147044;2;47672;3;47675
supportcase6;1206151;45090.732163;29.123967;1;1460;8;1468
supportcase7;1206151;-2396.218213;53.147310;2;1407;0;1407
swath;1206151;334.496858;2.200000;1;37;0;37
swath1;1206151;334.496858;0.600000;1;32;0;32
swath2;1206151;334.496858;0.700000;1;37;0;37
swath3;1206151;334.496858;0.800000;1;31;0;31
t1717;1206151;134531.021428;79.098998;1;200;0;200
t1722;1206151;98815.407611;52.399108;1;112;0;112
ta1-UUM;1206151;3693674.556772;4.303412;1;4;0;4
ta2-UUE;1206151;41427354.755773;0.680983;2;191;0;191
tanglegram1;1206151;0.000000;46.000000;1;2;0;2
tanglegram2;1206151;1.000000;26.500000;1;2;0;2
tanglegram4;1206151;4.000000;71.000000;1;4;0;4
tanglegram6;1206151;0.000000;33.500000;1;1;0;1
tbfp-bigm;1206151;-178.153988;30.000000;1;140;0;140
tbfp-network;1206151;23.261535;31.000000;1;775;3;778
Test3;1206151;2671255.210245;12.061384;1;99;0;99
thor50dday;1206151;203930.000000;0.000000;2;220;3;223
timtab1;1206151;1219185.333333;17.766667;2;0;0;0
timtab1CUTS;1206151;613590.095426;34.399586;2;3;0;3
timtab2;1206151;1602354.333333;29.200000;2;1;0;1
tokyometro;1206151;4658.136055;267.420569;3;66;0;66
toll-like;1206151;28.000000;229.000000;1;31;0;31
tpl-tub-ss16;1206151;8128588.328716;1889.575939;3;85017;152;85169
tpl-tub-ws1617;1206151;10755112.807538;2191.381057;3;98723;181;98904
tr12-30;1206151;188435.464884;3.580258;2;2;0;2
traininstance2;1206151;0.000000;8.029580;2;37;0;37
traininstance6;1206151;0.000000;3.486662;2;28;0;28
transportmoment;1206151;-55084931301.156029;426.403696;2;175;0;175
trento1;1206151;5182758.848056;76.321422;1;694;0;694
triptim1;1206151;22.921100;1825.087353;3;7829;9;7838
triptim2;1206151;11.878757;549.675189;3;11270;7;11277
triptim3;1206151;14.147151;635.932223;3;10282;7;10289
triptim4;1206151;9.526100;370.406250;3;10618;7;10625
triptim7;1206151;3080.288157;494.758033;2;11103;5;11108
triptim8;1206151;3074.310409;490.021225;2;12635;6;12641
tw-myciel4;1206151;22.000000;71.524648;6;245;1;246
uc-case11;1206151;611621.305979;111.729871;1;2738;0;2738
uc-case3;1206151;7181.432113;95.258578;3;1992;1;1993
uccase10;1206151;38995.965187;400.440843;1;2780;3;2783
uccase12;1206151;11507.474829;29.321333;3;2355;3;2358
uccase7;1206151;26527.823515;162.338874;1;3829;0;3829
uccase8;1206151;11142.163196;63.982247;1;1445;0;1445
uccase9;1206151;10819.582996;76.021210;1;933;0;933
uct-subprob;1206151;242.000000;57.638355;1;61;0;61
umts;1206151;43380098.519492;76.628947;2;17;0;17
unitcal_7;1206151;19450489.742819;144.660904;6;757;1;758
usAbbrv-8-25_70;1206151;95.000000;101.721317;3;7;0;7
usafa;1206151;178.602081;3104.483345;2;45144;25;45169
v150d30-2hopcds;1206151;52.000000;-0.000000;3;108;1;109
van;1206151;3.717453;12.910186;1;8215;0;8215
var-smallemery-m6j6;1206151;-156.056268;89.220998;2;766;4;770
vpm2;1206151;15.721505;3.393512;2;0;0;0
vpphard;1206151;0.000000;127.270065;1;75;0;75
vpphard2;1206151;0.000000;236.643537;1;81;0;81
wachplan;1206151;-9.000000;66.068516;1;9;0;9
wnq-n100-mw99-14;1206151;224.318143;77.196581;2;119;1;120
xmas10-2;1206151;-537.008669;157.129457;1;223;0;223
xmas10;1206151;-537.008669;157.318400;1;188;0;188
z26;1206151;-981.000000;-0.000000;3;13225;9;13234
zeil;1206151;813.510308;818.615660;1;85949;6;85955
zib54-UUE;1206151;19164366.000000;-0.000000;2;48;0;48