Instance;Seed;Cost;Fractionality;Rounds;LPtime(ms);ZItime(ms);LP+ZItime(ms);Gap(%)
10teams;1206151;917;36.45783;1;37;0;37;100
22433;1206151;21552.708079;24.962328;5;5;0;5;100
23588;1206151;8342.863244;17.617619;4;3;0;3;100
2club200v15p5scn;1206151;-96.055556;38.611111;7;127;3;130;100
30n20b8;1206151;5530;16.175931;2;101;1;102;100
30_70_45_05_100;1206151;105;0;5;863;3;866;100
30_70_45_095_100;1206151;58;0;5;817;2;819;100
30_70_45_095_98;1206151;369;0;6;846;3;849;100
50v-10;1206151;1493601.476062;0;2;8;0;8;100
a1c1s1;1206151;20912.873333;0.041667;2;36;0;36;100
a2c1s1;1206151;20866.0825;0;2;36;0;36;91.62
ab51-40-100;1206151;-6461729251;0;3;901;1;902;37.99
ab67-40-100;1206151;-7069213256;0;3;2605;4;2609;36.8
ab69-40-100;1206151;-7004957457;0;3;2081;1;2082;37.38
ab71-20-100;1206151;-6510510462;0;3;251;1;252;37.52
ab72-40-100;1206151;-6898618453.00001;0;3;804;1;805;38.33
academictimetablebig;1206151;32;1997.079231;2;3147;23;3170;100
academictimetablesmall;1206151;0;324.85601;2;230;3;233;100
acc-tight2;1206151;0;129.034401;1;33;0;33;100
acc-tight4;1206151;0;135.271717;1;59;0;59;100
acc-tight5;1206151;0;121.269585;1;255;0;255;100
acc-tight6;1206151;0;123.251301;1;278;0;278;100
adult-max5features;1206151;0.081316;0.266955;1;899;3;902;100
adult-regularized;1206151;0.077684;0.234052;1;1983;3;1986;100
aflow30a;1206151;983.167425;6.510845;1;5;0;5;100
aflow40b;1206151;1005.664817;8.247724;1;19;0;19;100
air03;1206151;338864.25;11.875;1;66;0;66;100
air04;1206151;55535.436388;52.288553;1;225;0;225;100
air05;1206151;25877.609268;46.215654;1;143;0;143;100
aligninq;1206151;2755;40.921868;7;16;1;17;100
allcolor10;1206151;6;749.769481;2;144;1;145;100
allcolor58;1206151;42;3883.60245;1;1221;4;1225;100
amaze22012-03-15i;1206151;0;0;1;72;1;73;0
amaze22012-06-28i;1206151;0;0;1;24;0;24;0
amaze22012-07-04i;1206151;0;0;1;32;0;32;0
app1-1;1206151;-2;0.179678;3;59;0;59;100
app1-2;1206151;-23;1e-06;2;4038;1;4039;100
app2-1;1206151;19298.5;0;2;41;0;41;0.02
app2-2;1206151;219402.5;0;3;1;0;1;3.47
app3;1206151;5627412.287938;3.142492;1;38;0;38;100
arki001;1206151;7579599.807787;17.164714;1;32;0;32;100
assign1-10-4;1206151;353.992926;52;1;36;0;36;100
assign1-5-8;1206151;183.362555;24;1;2;0;2;100
atlanta-ip;1206151;81.243206;325.689509;3;4614;6;4620;100
atm20-100;1206151;2141734.684878;124.301066;2;95;0;95;100
australia-abs-cta;1206151;0;39.202778;1;96;0;96;100
b-ball;1206151;-1.818182;4.818182;1;0;0;0;100
b1c1s1;1206151;69966.45;0;2;35;0;35;100
b2c1s1;1206151;70651.01;0;2;37;0;37;100
bab1;1206151;-286923.824223;50.52;1;282;7;289;100
bab2;1206151;-350926.440227;560.525267;2;8583;27;8610;100
bab3;1206151;-579370.271196;518.325237;2;34022;48;34070;100
bab5;1206151;-111134.599976;185.90025;2;530;2;532;100
bab6;1206151;-224575.783183;667.210836;2;6020;16;6036;100
bc;1206151;13.063318;0.063318;2;104;0;104;100
bc1;1206151;6.45558;0.016336;2;100;0;100;100
beasleyC1;1206151;102;0;2;2;0;2;20
beasleyC2;1206151;232;0;2;2;0;2;61.11
beasleyC3;1206151;958;0;2;4;0;4;27.06
beavma;1206151;407840.4;0;3;1;0;1;6.41
berlin;1206151;1741;0;2;32;0;32;66.76
berlin_5_8_0;1206151;52;70.73383;3;5;0;5;100
bg512142;1206151;323992.007013;52.989642;3;27;0;27;100
biella1;1206151;3060037.430763;98.771008;1;254;0;254;100
bienst1;1206151;11.724138;4.390524;1;2;0;2;100
bienst2;1206151;11.724138;5.390524;1;2;0;2;100
binkar10_1;1206151;6637.188027;9.084811;1;7;0;7;100
blend2;1206151;7.489992;0.492283;2;0;0;0;100
bley_xl1;1206151;265.699568;343.861165;6;22286;27;22313;100
bley_xs1;1206151;213538830.272187;107.27048;3;145;0;145;100
bley_xs1noM;1206151;251120149.512445;78.38821;8;118;1;119;100
bley_xs2;1206151;48593009.277766;66.02141;2;19;0;19;100
blp-ar98;1206151;14303.194003;9.189386;9;99;15;114;100
blp-ic97;1206151;6123.238237;3.473359;16;85;18;103;100
blp-ic98;1206151;14141.050706;0.1;4;127;7;134;100
blp-ir98;1206151;5639.818879;2.497817;2;44;1;45;100
bmocbd;1206151;-32041010095048.5;0;1;766;8;774;0
bmocbd2;1206151;-31953009810558.2;0;1;725;6;731;0
bmocbd3;1206151;45423160355.8175;0;2;16494;12;16506;100
bmoipr2;1206151;-46628940.711141;0.184434;3;85;1;86;100
bnatt350;1206151;0;93.793362;6;68;1;69;100
bnatt400;1206151;0;109.069591;9;73;2;75;100
bppc4-08;1206151;51.59;9.776528;1;15;0;15;100
bppc6-02;1206151;108.34;11.886994;1;145;0;145;100
bppc6-06;1206151;200.633333;14.947367;1;163;0;163;100
bppc8-02;1206151;486.5;3.204377;1;1;0;1;100
bppc8-09;1206151;444.436047;5.98123;1;4;0;4;100
brasil;1206151;31819;0;2;26;0;26;100
brazil3;1206151;2;656.675844;1;1011;1;1012;100
breastcancer-regularized;1206151;0.00046;0.002809;1;8;0;8;100
bts4-cta;1206151;33524.637606;1130;1;601;0;601;100
buildingenergy;1206151;33246.215059;1468.85;2;16230;4;16234;100
cap6000;1206151;-2446875;0;3;43;1;44;0.18
cbs-cta;1206151;0;27.74603;1;113;0;113;100
cdc7-4-3-2;1206151;-231;0;3;37689;6;37695;19.79
chromaticindex1024-7;1206151;4;16002.682953;2;2512;11;2523;100
chromaticindex128-5;1206151;4;2021.163699;2;166;1;167;100
chromaticindex256-8;1206151;4;4069.477083;2;464;2;466;100
chromaticindex32-8;1206151;4;504.8875;2;21;0;21;100
chromaticindex512-7;1206151;4;8183.527137;2;1177;5;1182;100
ci-s4;1206151;4.963809;19.526141;2;65;0;65;100
circ10-3;1206151;140;155.071429;1;182;1;183;100
cmflsp40-24-10-7;1206151;52605868.952858;70.70093;3;367;0;367;100
cmflsp40-36-2-10;1206151;72898024.959478;295.649246;3;1000;0;1000;100
cmflsp50-24-10-4;1206151;64492612.641644;81.236085;3;387;0;387;100
cmflsp50-24-8-8;1206151;59814378.749021;131.86946;3;387;0;387;100
cmflsp60-36-2-6;1206151;97887903.946142;370.689759;3;1982;0;1982;100
CMS750_4;1206151;250;258.584847;3;116;1;117;100
co-100;1206151;1250429.774879;9.799423;2;296;22;318;100
cod105;1206151;-8;0;3;480;1;481;33.33
comp07-2idx;1206151;0;139.65;2;1486;2;1488;100
comp08-2idx;1206151;0;189.588538;3;163;1;164;100
comp12-2idx;1206151;11;251.466598;3;1263;2;1265;100
comp16-3idx;1206151;4;720.391848;1;8422;2;8424;100
comp21-2idx;1206151;0;197.95;2;951;1;952;100
control30-3-2-3;1206151;-20763026.787568;27.97054;1;5;0;5;100
core2536-691;1206151;803;0;3;1437;4;1441;16.55
core2586-950;1206151;1162;0;3;901;3;904;22.57
core4284-1064;1206151;1300;0;3;4903;5;4908;22.3
core4872-1529;1206151;1844;0;3;2880;5;2885;20.52
cost266-UUE;1206151;42001606.28;0;2;83;0;83;67.01
cov1075;1206151;35;0;2;7;0;7;75
cryptanalysiskb128n5obj16;1206151;0;7174.215397;2;839;6;845;100
csched007;1206151;269.251587;22.185714;1;37;0;37;100
csched008;1206151;171;19.560203;1;9;0;9;100
csched010;1206151;332.422727;19.770202;1;38;0;38;100
cvrpa-n64k9vrpi;1206151;0;206.143617;1;345;3;348;100
cvrpb-n45k5vrpi;1206151;0;154.740458;1;142;1;143;100
cvrpp-n16k8vrpi;1206151;0;50.204545;1;43;0;43;100
cvrpsimple2i;1206151;0;19.85;1;2;0;2;100
cvs08r139-94;1206151;-24;0;3;17;0;17;79.31
cvs16r106-72;1206151;-10;0;3;30;0;30;87.65
cvs16r128-89;1206151;-11;0;3;37;0;37;88.66
cvs16r70-62;1206151;-5;0;3;32;0;32;88.1
cvs16r89-60;1206151;-7;0;3;30;0;30;89.23
d10200;1206151;12425.583005;34.236879;1;49;0;49;100
d20200;1206151;12229.625788;62.339279;1;347;0;347;100
dale-cta;1206151;0;0.004764;1;305;0;305;100
dano3mip;1206151;576.23162;15.294513;1;1601;0;1601;100
dano3_3;1206151;576.23162;1.932181;1;1788;0;1788;100
dano3_5;1206151;576.23162;2.871834;1;1700;0;1700;100
danoint;1206151;62.63728;5.819184;1;18;0;18;100
dc1c;1206151;1754946.863638;139.834191;1;315;1;316;100
dc1l;1206151;203554787.784329;0;3;1269;17;1286;100
dcmulti;1206151;184858.396836;12.823814;3;3;0;3;100
decomp1;1206151;-120;98;1;47;0;47;100
decomp2;1206151;-160;93.138889;1;52;0;52;100
dfn-bwin-DBE;1206151;797567.4;0;2;39;0;39;100
dfn-gwin-UUM;1206151;27467.257235;5.653537;1;1;0;1;100
dg012142;1206151;5895516.340434;39.442147;5;211;0;211;100
diameterc-mstc-v20a190d5i;1206151;291;56.7;1;36;0;36;100
diameterc-msts-v40a100d5i;1206151;324;100.121212;1;34;0;34;100
disctom;1206151;-5000;51.166667;1;249;0;249;100
disktom;1206151;-5000;51.166667;1;196;0;196;100
dolom1;1206151;6556066.068315;110.606017;1;470;1;471;100
drayage-100-12;1206151;21458.311901;45.375525;1;59;0;59;100
drayage-100-23;1206151;11714.141979;44.659861;1;142;0;142;100
drayage-25-23;1206151;11714.141979;44.421956;1;135;0;135;100
drayage-25-27;1206151;26785.797043;41.335416;1;61;0;61;100
drayage-25-32;1206151;32519.997253;41.203921;1;64;0;64;100
ds-big;1206151;86.820068;30.669231;1;8121;22;8143;100
ds;1206151;57.234565;33.463549;1;1042;8;1050;100
dws008-01;1206151;708.876687;16.484655;2;76;0;76;100
dws008-03;1206151;717.896796;9.217365;2;143;2;145;100
dws012-01;1206151;3450.401707;26.235704;2;136;1;137;100
dws012-02;1206151;1584.690892;16.166549;2;227;3;230;100
dws012-03;1206151;1998.123968;18.170643;2;317;4;321;100
eil33-2;1206151;811.278996;3.61563;1;37;0;37;100
eilA101-2;1206151;803.373888;7.408683;1;953;7;960;100
eilB101;1206151;1075.247691;12.807028;1;23;0;23;100
eilC76-2;1206151;725.754458;7.780208;1;293;2;295;100
ej;1206151;1;0.243844;1;0;0;0;100
elitserienhandball11i;1206151;0;1421.352265;1;248;1;249;100
elitserienhandball13i;1206151;0;1357.692232;1;268;1;269;100
elitserienhandball14i;1206151;0;1543.7577;1;249;1;250;100
elitserienhandball3i;1206151;0;1525.315516;1;240;1;241;100
enlight13;1206151;0;0.5;1;0;0;0;100
enlight15;1206151;0;0.5;1;0;0;0;100
enlight8;1206151;0;0.5;1;0;0;0;100
enlight_hard;1206151;0;14.5;1;0;0;0;100
eva1aprime5x5opt;1206151;-497.247729;0.959853;1;365;0;365;100
eva1aprime6x6opt;1206151;-495.49243;9.408398;1;1703;0;1703;100
ex10;1206151;100;100;1;18362;7;18369;100
ex1010-pi;1206151;314;0;3;880;5;885;33.62
ex9;1206151;81;81;1;1745;3;1748;100
exp-1-500-5-5;1206151;97666.305541;4.045842;2;2;0;2;100
f2000;1206151;1383;1280;2;3766;0;3766;100
f2gap201600;1206151;76429.862296;1.402159;1;3;0;3;100
f2gap401600;1206151;82274.237434;1.19002;1;4;0;4;100
f2gap40400;1206151;20650.898154;3.25358;1;1;0;1;100
f2gap801600;1206151;86570.120867;5.266841;1;5;0;5;100
fast0507;1206151;221;0;3;563;12;575;27.01
fastxgemm-n2r6s0t2;1206151;27;9;1;38;0;38;100
fastxgemm-n2r7s4t1;1206151;27;9;1;41;0;41;100
fastxgemm-n3r21s3t6;1206151;84;27;1;2402;0;2402;100
fastxgemm-n3r22s4t6;1206151;84;27;1;2658;0;2658;100
fastxgemm-n3r23s5t6;1206151;84;27;1;2707;0;2707;100
fhnw-binpack4-48;1206151;0;333.285714;2;128;0;128;100
fhnw-binpack4-58;1206151;0;467.321429;2;137;1;138;100
fhnw-binpack4-77;1206151;0;207.310714;2;122;0;122;100
fhnw-binschedule0;1206151;12632.888779;685.581929;3;11627;46;11673;100
fhnw-binschedule2;1206151;1706.886254;154.751416;3;211;4;215;100
fhnw-schedule-paira100;1206151;-36.643681;5.147307;2;148;0;148;100
fhnw-schedule-paira200;1206151;-73.826479;8.938667;2;256;3;259;100
fhnw-schedule-paira400;1206151;-146.941079;19.26431;2;1406;13;1419;100
fhnw-schedule-pairb200;1206151;-73.826479;516.184695;2;1205;5;1210;100
fhnw-schedule-pairb400;1206151;-146.941079;2338.646383;2;8054;21;8075;100
fhnw-sq2;1206151;0;15.527645;1;4;0;4;100
fiball;1206151;137.069168;68.996028;1;121;1;122;100
fiber;1206151;1023943.76;9.839127;2;3;0;3;100
fillomino7x7-0i;1206151;0;0;1;31;0;31;0
fixnet6;1206151;12170;0;2;1;0;1;100
fjspeasy01i;1206151;216;0;1;38;0;38;0
flugpl;1206151;1167185.725592;3.538918;1;0;0;0;100
g200x740;1206151;45614;0;2;2;0;2;2.93
g200x740i;1206151;44069;0;2;2;0;2;46.48
gasprod1-1;1206151;4539.90753;51.5198;7885;822;6564;7386;100
gasprod1-2;1206151;1691.141291;51.497411;6853;556;4874;5430;100
gasprod1-3;1206151;3682.336923;49.221179;8368;570;6067;6637;100
gasprod2-1;1206151;1306101.609201;404.201103;19;1773;16;1789;100
gasprod2-2;1206151;1330631.091637;502.800224;36;1779;28;1807;100
gen-ip002;1206151;-511.036897;0;3;0;0;0;89.32
gen-ip016;1206151;-9505.628173;1.906914;1;0;0;0;100
gen-ip021;1206151;6642.05262;2.217259;4;0;0;0;100
gen-ip036;1206151;-2162.833562;0;3;0;0;0;53.05
gen-ip054;1206151;16786.476526;1.032398;5;0;0;0;100
gen;1206151;112130.040664;7.929263;1;3;0;3;100
genus-g31-8;1206151;-27;112.333333;1;1042;1;1043;100
genus-g61-25;1206151;-58;262.979034;1;847;2;849;100
genus-sym-g31-8;1206151;-27;154.805251;2;3942;3;3945;100
genus-sym-g62-2;1206151;-54;255.080518;2;22283;3;22286;100
genus-sym-grafo5708-48;1206151;-27;115.165439;1;1264;0;1264;100
ger50-17-ptp-pop-3t;1206151;3466.324873;45.213645;1;114;0;114;100
ger50-17-ptp-pop-6t;1206151;6804.447088;50.477969;1;93;0;93;100
ger50-17-trans-dfn-3t;1206151;3453.475245;37.741927;1;151;1;152;100
ger50-17-trans-pop-3t;1206151;3456.252922;49.487013;1;160;1;161;100
ger50_17_trans;1206151;6850.628623;48.22611;1;141;1;142;100
germanrr;1206151;46445702.956442;53.468182;2;668;3;671;100
germany50-DBM;1206151;438028;23.4;1;134;0;134;100
germany50-UUM;1206151;597932.5;24.4;1;32;0;32;100
gesa2-o;1206151;25748173.191117;13.380406;2;4;0;4;100
gesa2;1206151;25477017.874283;13.26737;2;6;0;6;100
gfd-schedulen180f7d50m30k18-16i;1206151;18;108.385679;1;5881;88;5969;100
gfd-schedulen180f7d50m30k18;1206151;1;5019.413851;2;3585;21;3606;100
gfd-schedulen25f5d20m10k3i;1206151;3;13.619895;1;61;1;62;100
gfd-schedulen55f2d50m30k3i;1206151;3;27.695911;1;160;3;163;100
ghoulomb4-9-10i;1206151;9;0;1;67;1;68;0
glass-sc;1206151;23;0;3;117;1;118;0
glass4;1206151;800002400;2.059524;1;1;0;1;100
gmu-35-40;1206151;-2400283.756506;1.911023;2;9;0;9;100
gmu-35-50;1206151;-2606307.146543;3.420099;2;20;0;20;100
gmut-75-50;1206151;-14182312.661731;4.988967;1;586;6;592;100
gmut-76-40;1206151;-14171086.316075;9.054451;1;245;1;246;100
gmut-76-50;1206151;-14173884.188063;4.201959;1;490;5;495;100
gmut-77-40;1206151;-14173396.636852;2.97325;1;237;1;238;100
go19;1206151;96;0;3;4;0;4;14.29
gr4x6;1206151;229.05;0;2;0;0;0;13.19
graph20-20-1rand;1206151;-37;48;1;37;0;37;100
graph20-80-1rand;1206151;-117;142;1;1575;1;1576;100
graph40-20-1rand;1206151;-157;185.5;1;4354;3;4357;100
graph40-40-1rand;1206151;-300;341.96929;1;92282;10;92292;100
graphdraw-domain;1206151;12672;21.071817;1;2;0;2;100
graphdraw-gemcutter;1206151;4310;15.521554;1;1;0;1;100
graphdraw-grafo2;1206151;35762;368.152985;1;813;3;816;100
graphdraw-mainerd;1206151;30496;97.975651;1;87;0;87;100
graphdraw-opmanager;1206151;54717;207.745488;1;406;1;407;100
gsvm2rl11;1206151;35640.343493;0;2;361;0;361;96.67
gsvm2rl12;1206151;50;0;2;496;0;496;100
gsvm2rl3;1206151;0.6;0;2;3;0;3;78.29
gsvm2rl5;1206151;10;0;2;9;0;9;84.4
gsvm2rl9;1206151;16356.825869;0;2;57;0;57;100
gt2;1206151;13460.233074;0.728107;1;0;0;0;100
h50x2450;1206151;11147.731511;3.696751;1;32;0;32;100
h80x6320;1206151;3700;0;1;26;0;26;0
h80x6320d;1206151;5325.160104;2.515625;1;41;0;41;100
hanoi5;1206151;1926;332;4;161;1;162;100
haprp;1206151;3665963.213506;96.940858;1;4;0;4;100
harp2;1206151;-74353341.5023;5.485338;1;6;0;6;100
hgms-det;1206151;-53824.391476;32.676364;1;236;0;236;100
hgms30;1206151;-53349.215497;60.694272;1;8976;0;8976;100
hgms62;1206151;-53416.649907;61.317531;1;26532;0;26532;100
hypothyroid-k1;1206151;-2902.852586;39.591978;1;7513;2;7515;100
ic97_potential;1206151;4089;54.966667;2;3;0;3;100
ic97_tension;1206151;3911;15.366667;2;2;0;2;100
icir97_potential;1206151;6612;166.866667;2;42;0;42;100
icir97_tension;1206151;6302;97.366667;2;4;0;4;100
iis-100-0-cov;1206151;41;0;3;104;0;104;41.38
iis-bupa-cov;1206151;49;0;3;168;1;169;36.11
iis-glass-cov;1206151;28;0;3;148;1;149;33.33
iis-hc-cov;1206151;22;0;3;194;3;197;29.41
iis-pima-cov;1206151;41;0;3;223;1;224;24.24
irp;1206151;12123.530222;6;1;92;1;93;100
istanbul-no-cutoff;1206151;51.11;3.607411;1;443;0;443;100
ivu06-big;1206151;135.427718;95.799872;1;56251;161;56412;100
ivu06;1206151;135.901353;97.120377;1;15698;54;15752;100
ivu52;1206151;480.250439;81.742183;1;6980;15;6995;100
ivu59;1206151;884.456993;122.893682;1;107703;219;107922;100
janos-us-DDM;1206151;1488134.75;22.375;1;4;0;4;100
k16x240;1206151;11359;0;2;0;0;0;6.42
k16x240b;1206151;12874;0;2;0;0;0;13
k1mushroom;1206151;-4165.061224;43.877551;1;16392;7;16399;100
k1mushroomi;1206151;-4208;0;1;180;6;186;0
khb05250;1206151;126785464;0;2;1;0;1;18.56
l2p12;1206151;2;1091.539196;1;342;0;342;100
l2p1i;1206151;1;333.207461;1;806;16;822;100
l2p2i;1206151;1;616.41646;1;74;1;75;100
lectsched-1-obj;1206151;0;5.975758;2;258;6;264;100
lectsched-1;1206151;0;3.151515;2;204;6;210;100
lectsched-2;1206151;0;17.149242;5;122;8;130;100
lectsched-3;1206151;0;21.203788;6;218;15;233;100
lectsched-4-obj;1206151;0;12.853788;6;68;4;72;100
lectsched-5-obj;1206151;0;4.117424;2;233;5;238;100
leo1;1206151;1181219706.24;0;3;76;2;78;100
leo2;1206151;1344214233.44;0;3;178;5;183;100
liu;1206151;346;11.003653;2;7;0;7;100
loopha13;1206151;6.279;1.10216;2;218;1;219;100
lotsize;1206151;1335747.052789;7.405615;2;6;0;6;100
lr1dr02vc05v8a-t360;1206151;120706.326475;174.298112;1;1079;1;1080;100
lr1dr04vc05v17a-t360;1206151;247111.69248;335.090553;1;1982;2;1984;100
lr1dr12vc10v70b-t360;1206151;983950.247945;1069.593454;1;46277;10;46287;100
lr2-22dr3-333vc4v17a-t60;1206151;-72838.215835;239.748662;2;38359;8;38367;100
lrn;1206151;42701141.648089;65.099086;2;457;0;457;100
m100n500k4r1;1206151;-20;0;3;6;0;6;20
macrophage;1206151;0;339;1;29;0;29;100
mad;1206151;0;3.254396;1;1;0;1;100
manna81;1206151;-11868;0;3;38;0;38;9.85
map06;1206151;-406.181173;7.868443;1;2434;1;2435;100
map10;1206151;-602.176181;11.248146;1;2738;1;2739;100
map14;1206151;-778.549324;11.962355;1;2163;1;2164;100
map14860-20;1206151;-998.836419;10.400693;1;2485;1;2486;100
map16715-04;1206151;-296.267898;4.997036;1;2302;1;2303;100
map18;1206151;-932.782685;11.173489;1;2292;1;2293;100
map20;1206151;-998.836419;10.400693;1;2517;1;2518;100
mappingmesh3x3mpeg2i;1206151;87.555556;87.202393;1;35;0;35;100
mario-t-hard5i;1206151;-4482;20.339623;1;1372;2;1374;100
markshare1;1206151;230;0;2;0;0;0;100
markshare2;1206151;454;0;2;0;0;0;100
markshare_4_0;1206151;226;0;2;0;0;0;100
markshare_5_0;1206151;337;0;2;0;0;0;100
mas74;1206151;10482.79528;3.103514;1;1;0;1;100
mas76;1206151;38893.903641;2.555097;1;1;0;1;100
maxgasflow;1206151;-70929535.9;662.35764;2;63;0;63;100
mc11;1206151;13509;0;2;32;0;32;15.57
mc7;1206151;5796;0;2;30;0;30;69.62
mc8;1206151;1929;0;2;27;0;27;23.18
mcsched;1206151;193774.753707;340.221655;1;124;0;124;100
methanosarcina;1206151;0;313;1;109;0;109;100
mik-250-1-100-1;1206151;0;0;2;2;0;2;100
mik-250-20-75-1;1206151;0;0;2;3;0;3;100
mik-250-20-75-2;1206151;0;0;2;3;0;3;100
mik-250-20-75-3;1206151;0;0;2;3;0;3;100
mik-250-20-75-4;1206151;0;0;2;3;0;3;100
mik-250-20-75-5;1206151;0;0;2;3;0;3;100
milo-v12-6-r1-58-1;1206151;410986.648167;129.9058;1;106;0;106;100
milo-v12-6-r1-75-1;1206151;669700.757896;208.836475;1;117;0;117;100
milo-v12-6-r2-40-1;1206151;205532.322265;97.329375;1;71;0;71;100
milo-v13-4-3d-3-0;1206151;23359.288017;1.476277;1;14;0;14;100
milo-v13-4-3d-4-0;1206151;34031.171805;2.550972;1;26;0;26;100
mine-166-5;1206151;-821763677.673139;187.331384;1;200;0;200;100
mine-90-10;1206151;-887165318.510226;202.375368;1;157;0;157;100
mining;1206151;-885962268.692866;8562.753844;62;127138;1526;128664;100
minutedispatchstrategy;1206151;1898.391429;412.137934;2;1468;2;1470;100
misc07;1206151;1415;8;1;2;0;2;100
mitre;1206151;114740.518481;224.156743;1;99;0;99;100
mkc;1206151;-581.85;16.208843;3;31;0;31;100
mkc1;1206151;-611.85;3.942199;3;33;0;33;100
mod010;1206151;6532.083333;14.166667;1;16;0;16;100
modglob;1206151;20786787.016883;0;2;2;0;2;0.22
moj-mining;1206151;-1520532907.35018;566.626558;2;46371;0;46371;100
momentum1;1206151;134660.011921;48.045264;2;1297;1;1298;100
momentum2;1206151;61266.821316;84.616225;3;786;2;788;100
momentum3;1206151;107721.82427;144.721031;3;9110;1;9111;100
mrcpspj30-15-5i;1206151;23;189.992887;1;44;0;44;100
mrcpspj30-17-10i;1206151;25;28.677778;1;37;0;37;100
mrcpspj30-53-3i;1206151;30;43.135185;1;36;0;36;100
msc98-ip;1206151;19520966.151663;393.288169;2;2735;2;2737;100
mspp16;1206151;341;1.241379;1;28059;148;28207;100
mspsphard01i;1206151;16;0;1;46;0;46;0
mspsphard03i;1206151;20;0;1;85;1;86;0
mtest4ma;1206151;60342;0;2;2;0;2;15.71
mushroom-best;1206151;1.3e-05;0.0202;1;515;1;516;100
mzzv11;1206151;-22556.460829;174.328454;2;424;1;425;100
mzzv42z;1206151;-18842.814586;198.473995;2;281;1;282;100
n13-3;1206151;14401970;0;2;26;0;26;100
n15-3;1206151;71710891;0;2;3395;0;3395;0
n2seq36f;1206151;71600;0;3;35;1;36;37.16
n2seq36q;1206151;116003.593822;43.392098;3;161;3;164;100
n3-3;1206151;24303430;0;2;155;0;155;100
n3700;1206151;1342560;0;2;28;0;28;9.36
n3705;1206151;1342540;0;2;32;0;32;9.55
n3707;1206151;1301218;0;2;31;0;31;9.65
n3709;1206151;1324904;0;2;32;0;32;9.68
n370a;1206151;1353042;0;2;30;0;30;0
n370b;1206151;1373791;0;2;31;0;31;11.06
n3div36;1206151;174200;0;3;146;6;152;33.18
n3seq24;1206151;189433.068485;51.670786;3;3002;60;3062;100
n4-3;1206151;13501875;0;2;49;0;49;100
n5-3;1206151;12301325;0;2;18;0;18;100
n6-3;1206151;16502900;0;2;37;0;37;100
n7-3;1206151;14704310;0;2;41;0;41;100
n9-3;1206151;20703625;0;2;155;0;155;100
nag;1206151;465;13.770256;3;46;0;46;100
neos-1061020;1206151;-145860.370608;500.756757;1;840;1;841;100
neos-1067731;1206151;669053;81.272727;1;639;0;639;100
neos-1109824;1206151;278;22;1;53;0;53;100
neos-1112782;1206151;22000000110147.3;0;2;24;0;24;100
neos-1112787;1206151;19500000125389.7;0;2;22;0;22;100
neos-1122047;1206151;161;0.495966;2;478;0;478;100
neos-1171448;1206151;-309;0.936995;2;83;0;83;100
neos-1171692;1206151;-273;3.730892;2;42;0;42;100
neos-1171737;1206151;-195;8.004699;2;43;0;43;100
neos-1225589;1206151;5e+09;0;2;1;0;1;100
neos-1311124;1206151;-182;5;2;3;0;3;100
neos-1324574;1206151;4.5;144;1;40;0;40;100
neos-1330346;1206151;4.5;76.5;1;127;0;127;100
neos-1337307;1206151;-201272;272.493985;2;51;0;51;100
neos-1354092;1206151;46;238.398385;2;1017;1;1018;100
neos-1367061;1206151;31320456.264497;3.75;2;1838;1;1839;100
neos-1396125;1206151;3000.053717;12.531496;2;8;0;8;100
neos-1420546;1206151;22124.4;103.140678;1;375;0;375;100
neos-1420790;1206151;2942.750002;75.132359;1;49;0;49;100
neos-1423785;1206151;-1816.666667;311.9714;1;256;0;256;100
neos-1425699;1206151;3175204364.6353;5.264952;1;0;0;0;100
neos-1426635;1206151;-178;6.429182;2;2;0;2;100
neos-1426662;1206151;-52;10.501303;2;4;0;4;100
neos-1429212;1206151;30;713.975748;1;5387;12;5399;100
neos-1430701;1206151;-78;6.669599;2;2;0;2;100
neos-1436709;1206151;-129;3.502607;2;3;0;3;100
neos-1440225;1206151;36;33.503789;1;96;0;96;100
neos-1440460;1206151;-180;4.85975;2;2;0;2;100
neos-1442119;1206151;-182;2.580471;2;3;0;3;100
neos-1442657;1206151;-156;4.002933;2;3;0;3;100
neos-1445532;1206151;-22877;8.21746;2;94;0;94;100
neos-1445738;1206151;-24232.548846;16.301135;1;169;0;169;100
neos-1445743;1206151;-24579.832968;16.920281;1;150;0;150;100
neos-1445765;1206151;-24699.19766;17.625849;1;150;0;150;100
neos-1456979;1206151;154;8.434222;1;39;0;39;100
neos-1516309;1206151;34769.833333;9.166667;2;29;0;29;100
neos-1582420;1206151;88.398466;56.693409;5;86;1;87;100
neos-1593097;1206151;4424;55.795872;1;106;1;107;100
neos-1599274;1206151;32194.742857;6.464286;3;42;1;43;100
neos-1601936;1206151;1;155.387702;1;757;0;757;100
neos-1603965;1206151;619244367.662955;0.000913;1;649;0;649;100
neos-1605061;1206151;6.150735;159.498166;1;2584;0;2584;100
neos-1605075;1206151;3.214461;176.495942;1;2231;0;2231;100
neos-1616732;1206151;174;0;3;6;0;6;9.43
neos-1620770;1206151;22;35;2;44;0;44;100
neos-2294525-abba;1206151;156.177251;16.071056;1;94;0;94;100
neos-2328163-agri;1206151;26069;54.9;1;71;0;71;100
neos-2624317-amur;1206151;0;33.918936;1;3;0;3;100
neos-2629914-sudost;1206151;39622;7.942933;1;218;0;218;100
neos-2652786-brda;1206151;0;19.477348;2;1;0;1;100
neos-2657525-crna;1206151;0;28.234944;2;2;0;2;100
neos-2669500-cust;1206151;2221.9;230.19862;2;1051;16;1067;100
neos-2746589-doon;1206151;1985.75;129.965898;2;307;6;313;100
neos-2974461-ibar;1206151;473452396.770997;3364;2;213419;34;213453;100
neos-2978193-inde;1206151;-2.418518;7.4;1;59;0;59;100
neos-2978205-isar;1206151;-12.415307;29.8;1;223;0;223;100
neos-2987202-jeir;1206151;-1847551552.23661;1035.632796;2;66624;1;66625;100
neos-2987310-joes;1206151;-610797465.676974;19.875;2;1738;0;1738;100
neos-2991472-kalu;1206151;459.673619;4.82467;13792;4432;761716;766148;100
neos-3004026-krka;1206151;0;832;1;58;0;58;100
neos-3009394-lami;1206151;0.642857;216.114286;2;4;0;4;100
neos-3024952-loue;1206151;22882;103.3;1;251;0;251;100
neos-3025225-shelon;1206151;0.052574;323.690533;1;102123;43;102166;100
neos-3046601-motu;1206151;185;0.4492;1;1;0;1;100
neos-3046615-murg;1206151;192;0.3458;1;1;0;1;100
neos-3048764-nadi;1206151;-3883988306.36669;0;2;42;0;42;0
neos-3065804-namu;1206151;0;0;1;194;0;194;0
neos-3068746-nene;1206151;77427529.530929;55.412658;2;151;0;151;100
neos-3072252-nete;1206151;10593526;1.938794;2;1;0;1;100
neos-3075395-nile;1206151;54.924462;0.00048;1;172;0;172;100
neos-3083784-nive;1206151;0;12;1;26;0;26;100
neos-3083819-nubu;1206151;6290575.552807;13.541087;1;48;0;48;100
neos-3116779-oban;1206151;0;0;1;23;0;23;0
neos-3118745-obra;1206151;357;0;2;3;0;3;40
neos-3148108-pahi;1206151;0;0;1;267;2;269;0
neos-3209462-rhin;1206151;0;49.45122;2;4000;1;4001;100
neos-3209519-ruhr;1206151;332.85;25.900482;1;57;0;57;100
neos-3214367-sovi;1206151;87802.732596;99.258257;1;2075;0;2075;100
neos-3216931-puriri;1206151;58817.353066;51.622705;1;1005;0;1005;100
neos-3226448-wkra;1206151;0;512.043709;1;783;0;783;100
neos-3237086-abava;1206151;0;96;1;263;2;265;100
neos-3322547-alsek;1206151;616;115.178534;2;10437;67;10504;100
neos-3352863-ancoa;1206151;495300;0;2;824;10;834;100
neos-3354841-apure;1206151;48447.926267;3.552995;1;2932;23;2955;100
neos-3355120-tarago;1206151;-20453473.616781;80.899969;1;627;1;628;100
neos-3355323-arnon;1206151;0;21.818182;4;80;3;83;100
neos-3372571-onahau;1206151;0.57699;8.695953;2;1465;0;1465;100
neos-3373491-avoca;1206151;21687686014.0154;26.555947;1;6;0;6;100
neos-3381206-awhea;1206151;432;61.334767;2;5;0;5;100
neos-3402294-bobin;1206151;0;35.009213;1;1034;9;1043;100
neos-3426085-ticino;1206151;235;41.78747;3;27;0;27;100
neos-3426132-dieze;1206151;427;103.670666;2;50;0;50;100
neos-3437289-erdre;1206151;0;0;1;104;1;105;0
neos-3530903-gauja;1206151;170;33.253136;3;5;0;5;100
neos-3530905-gaula;1206151;153;29.042208;2;4;0;4;100
neos-3555904-turama;1206151;-41.45;29.464286;1;842;4;846;100
neos-3572885-glina;1206151;0;0;1;388;2;390;0
neos-3581454-haast;1206151;1640;52;1;101;0;101;100
neos-3592146-hawea;1206151;7237144.855333;13.694653;1;39;0;39;100
neos-3594536-henty;1206151;383205;2496;1;152;1;153;100
neos-3603137-hoteo;1206151;0;34.208333;3;43;1;44;100
neos-3610040-iskar;1206151;45;0;2;2;0;2;21.62
neos-3610051-istra;1206151;64;0;2;8;0;8;30.61
neos-3610173-itata;1206151;180;0;2;6;0;6;21.62
neos-3611447-jijia;1206151;129;0;2;3;0;3;20.56
neos-3611689-kaihu;1206151;151;0;2;2;0;2;26.89
neos-3615091-sutlej;1206151;-1506391.117177;170;1;1864;10;1874;100
neos-3627168-kasai;1206151;1020229.4;0;2;4;0;4;3.2
neos-3634244-kauru;1206151;0;152.72;1;4552;9;4561;100
neos-3636886-kereu;1206151;4092.95754;2e-05;2;59;1;60;100
neos-3656078-kumeu;1206151;-18774.7;144.152983;2;221;1;222;100
neos-3660371-kurow;1206151;286.534383;18.305351;1;40;0;40;100
neos-3661949-lesse;1206151;688975700;0.00026;2;57;0;57;100
neos-3665875-lesum;1206151;248.325;39.496094;4;74;0;74;100
neos-3682128-sandon;1206151;79915933.274829;141.641588;2;300;1;301;100
neos-3691541-lonja;1206151;-0.079271;1.110009;2;45;1;46;100
neos-3695882-vesdre;1206151;-145935.214286;38.62531;1;564;3;567;100
neos-3696678-lyvia;1206151;4.90689;306.477181;2;50;0;50;100
neos-3699377-maori;1206151;135877.224265;88.272067;2;116;0;116;100
neos-3703351-marne;1206151;317056.210386;66.75637;2;61;0;61;100
neos-3740487-motru;1206151;152.145486;83.106404;2;41129;71;41200;100
neos-3754480-nidda;1206151;-1216923.270104;12.186832;1;3;0;3;100
neos-3755335-nizao;1206151;50.030157;72.893283;2;541;1;542;100
neos-3759587-noosa;1206151;48.334468;3.376667;2;329;1;330;100
neos-3761878-oglio;1206151;422769.022545;76.021852;2;44;0;44;100
neos-3762025-ognon;1206151;603955.746492;55.414542;2;38;0;38;100
neos-4165869-wannon;1206151;282.410166;67.168679;3;607;6;613;100
neos-4230265-orari;1206151;10055874880.8713;2982.245145;241;4362;160;4522;100
neos-4260495-otere;1206151;3336.109119;251.27169;2;781;16;797;100
neos-4285819-pedja;1206151;9.198014;17.924816;2;126631;83;126714;100
neos-4290317-perth;1206151;6352398.05574;0;2;683;1;684;100
neos-4292145-piako;1206151;203075008.660562;3215.980526;241;3405;170;3575;100
neos-4295773-pissa;1206151;0;3220.505376;1;5208;5;5213;100
neos-4300652-rahue;1206151;0;49;2;736;2;738;100
neos-4306827-ravan;1206151;-35696.901913;2144.305389;5;754;29;783;100
neos-4321076-ruwer;1206151;1880.558333;39.333333;1;15633;1;15634;100
neos-4322846-ryton;1206151;0.419848;26;1;493;5;498;100
neos-4332801-seret;1206151;222328.384492;6070.103294;3;126108;2706;128814;100
neos-4332810-sesia;1206151;-33931.341204;4092.28388;13;118382;9658;128040;100
neos-4333464-siret;1206151;24.731464;0.125;2;69;1;70;100
neos-4333596-skien;1206151;-14653956.91493;0.180763;1;21;0;21;100
neos-4335793-snake;1206151;0;300.868689;2;1114;2;1116;100
neos-4338804-snowy;1206151;1447;0.33;3;5;0;5;100
neos-4343293-stony;1206151;51.62736;0.5;2;69;0;69;100
neos-4355351-swalm;1206151;33.822611;0.094819;2;200;3;203;100
neos-4358725-tagus;1206151;6199.400001;198.323744;73;602;20;622;100
neos-4359986-taipa;1206151;0.296593;39.062139;1;1110;1;1111;100
neos-4360552-sangro;1206151;-29.5;557.645354;1;12889;2;12891;100
neos-4387871-tavua;1206151;36.445048;0.2;2;52;0;52;100
neos-4391920-timok;1206151;9e-06;37.747142;1;7843;5;7848;100
neos-4393408-tinui;1206151;340.267489;0.2;2;43;0;43;100
neos-4408804-prosna;1206151;914.483516;66.321429;1;2666;1;2667;100
neos-4409277-trave;1206151;0;347.723278;1;2120;1;2121;100
neos-4413714-turia;1206151;43.474651;371.333441;1;1910;10;1920;100
neos-4532248-waihi;1206151;0;26.333333;1;668;4;672;100
neos-4533806-waima;1206151;3063.318841;99;1;1120;10;1130;100
neos-4545615-waita;1206151;3606.59419;108.263827;1;15318;63;15381;100
neos-4555749-wards;1206151;3026.812121;68.666667;1;949;13;962;100
neos-4562542-watut;1206151;3743.304348;85.428571;1;3685;13;3698;100
neos-4647027-thurso;1206151;26911.641616;127.083433;1;2478;0;2478;100
neos-4647030-tutaki;1206151;26911.641616;130.175014;1;2829;0;2829;100
neos-4647032-veleka;1206151;26587.908699;174.815461;1;3847;0;3847;100
neos-4650160-yukon;1206151;-22688.54768;228.864;1;5;0;5;100
neos-4722843-widden;1206151;1841.255082;1452.768981;2;422;6;428;100
neos-4724674-aorere;1206151;3758.753179;59.078997;3;502;12;514;100
neos-4736745-arroux;1206151;653873224.676537;1.560199;2;43;0;43;100
neos-4738912-atrato;1206151;617323325.173629;52.400465;2;50;1;51;100
neos-4754521-awarau;1206151;0;0;1;1146;6;1152;0
neos-4760493-puerua;1206151;1908.243695;237.071976;1;32731;2;32733;100
neos-476283;1206151;406.244708;4.622056;2;4415;0;4415;100
neos-4763324-toguru;1206151;1120.986062;232.945926;1;33755;3;33758;100
neos-4797081-pakoka;1206151;0;827.858104;1;5911;2;5913;100
neos-4805882-barwon;1206151;1676.929283;206.756435;2;210;1;211;100
neos-480878;1206151;515.138796;1.008444;2;17;0;17;100
neos-4954274-beardy;1206151;18659.208282;301.285291;2;967;2;969;100
neos-4954672-berkel;1206151;3733961;4.007059;2;4;0;4;100
neos-4966258-blicks;1206151;354.545455;450.828848;3;1478;4;1482;100
neos-4971100-bodrog;1206151;0;0;2;78;0;78;100
neos-4972437-bojana;1206151;355.557128;31.979415;2;8749;4;8753;100
neos-4972461-bolong;1206151;465.045599;50.250248;2;4782;3;4785;100
neos-4976951-bunnoo;1206151;375.694372;25.259996;2;6986;4;6990;100
neos-4984115-canche;1206151;-10414620.716097;6.967648;1;17547;0;17547;100
neos-498623;1206151;16;44.05751;1;128;1;129;100
neos-5013590-toitoi;1206151;1064.447092;169;1;12565;1;12566;100
neos-5018451-chiese;1206151;-149772385.216405;18.530618;1;65170;1;65171;100
neos-503737;1206151;50;47.555718;1;33;0;33;100
neos-5041822-cockle;1206151;5696053.417116;2.418448;3;2739;31;2770;100
neos-5044663-wairoa;1206151;4653100;541.481293;1;21912;2;21914;100
neos-5045105-creuse;1206151;19.06667;21.458183;1;84;0;84;100
neos-5049753-cuanza;1206151;464;69.6;3;2456;6;2462;100
neos-5051588-culgoa;1206151;128.75;31.449091;1;113;0;113;100
neos-5052403-cygnet;1206151;219.147435;87.133886;8;37130;161;37291;100
neos-506422;1206151;0;6.9;1;43;0;43;100
neos-506428;1206151;145945;95.648936;1;532;3;535;100
neos-5075914-elvire;1206151;277.341888;3.120913;2;56;0;56;100
neos-5076235-embley;1206151;1930;0.115385;2;805;0;805;100
neos-5078479-escaut;1206151;7280.474567;0.467977;2;39;0;39;100
neos-5079731-flyers;1206151;2004;1.087912;2;852;0;852;100
neos-5083528-gimone;1206151;0;20.875;1;253;4;257;100
neos-5093327-huahum;1206151;3934;1.841667;2;930;0;930;100
neos-5100895-inster;1206151;2084;3.582418;2;596;0;596;100
neos-5102383-irwell;1206151;1740;2.483516;2;968;0;968;100
neos-5104907-jarama;1206151;639.917149;50.953837;2;9499;4;9503;100
neos-5106984-jizera;1206151;721;3.5;2;3993;7;4000;100
neos-5107597-kakapo;1206151;0;0.59125;2;42;0;42;100
neos-5108386-kalang;1206151;620.501637;57.690941;2;13708;8;13716;100
neos-5114902-kasavu;1206151;518;138;3;13027;14;13041;100
neos-5115478-kaveri;1206151;0;0.529375;2;41;0;41;100
neos-5116085-kenana;1206151;452;142;3;5708;11;5719;100
neos-5118834-korana;1206151;569.216333;123.504863;2;12340;6;12346;100
neos-5118851-kowhai;1206151;1134;5.88;2;5710;8;5718;100
neos-5123665-limmat;1206151;652.42743;71.017903;2;17305;9;17314;100
neos-5125849-lopori;1206151;0;51.956886;1;45;0;45;100
neos-5129192-manaia;1206151;0;3.769231;1;4432;13;4445;100
neos-5138690-middle;1206151;605.364996;106.306535;2;16423;8;16431;100
neos-5140963-mincio;1206151;8877;2.142857;1;1;0;1;100
neos-5149806-wieprz;1206151;0.027694;5.514108;5;463;18;481;100
neos-5151569-mologa;1206151;686023627.750363;27.702234;2;2108;3;2111;100
neos-5178119-nalagi;1206151;8.569859;18.661577;2;69;0;69;100
neos-5182409-nasivi;1206151;0;18.212177;1;7;0;7;100
neos-5188808-nattai;1206151;0;13.024442;1;421;0;421;100
neos-5189128-totara;1206151;330131.390743;21.863581;1;974;2;976;100
neos-5192052-neckar;1206151;-11980000;0.333333;3;0;0;0;100
neos-5193246-nerang;1206151;0;792.331614;1;828;1;829;100
neos-5195221-niemur;1206151;0;700.447361;1;900;1;901;100
neos-5196530-nuhaka;1206151;0;750.534707;1;581;1;582;100
neos-520729;1206151;-1391291.666667;8.76;1;552;1;553;100
neos-5221106-oparau;1206151;0;61.698592;1;277;1;278;100
neos-5223573-tarwin;1206151;0.1058;0.258185;1;16169;3;16172;100
neos-5251015-ogosta;1206151;0.1058;0.226665;1;12769;2;12771;100
neos-525149;1206151;60;3.5;1;290;5;295;100
neos-5260764-orauea;1206151;58748.022532;10.633838;1;63;0;63;100
neos-5261882-treska;1206151;22721.328;6.436135;1;14;0;14;100
neos-5266653-tugela;1206151;20969.906674;15.508215;1;146;1;147;100
neos-5273874-yomtsa;1206151;0;0.2152;1;15120;2;15122;100
neos-555001;1206151;910619.201473;185.329242;1;39;0;39;100
neos-555343;1206151;1241512.54944;273.503416;1;41;0;41;100
neos-555424;1206151;1196312.54944;237.883186;1;39;0;39;100
neos-555884;1206151;1026121.836055;271.3209;1;43;0;43;100
neos-565672;1206151;43884.639336;66.477422;3;15865;18;15883;100
neos-574665;1206151;4948073.456141;10.746401;1;40;0;40;100
neos-578379;1206151;0;134.758643;1;1159;1;1160;100
neos-585192;1206151;-1999690.155301;98.986683;2;164;0;164;100
neos-585467;1206151;-1999711.795869;82.239088;2;22;0;22;100
neos-595904;1206151;61134.474995;16.114622;2;65;0;65;100
neos-619167;1206151;1.481241;34.850492;1;101;0;101;100
neos-631517;1206151;6494999.999936;60.866544;1;9;0;9;100
neos-631710;1206151;544;293.45197;2;6596;19;6615;100
neos-633273;1206151;4678552871.15256;377.739286;1;189;0;189;100
neos-662469;1206151;184340.629649;96.375734;1;420;1;421;100
neos-686190;1206151;5134.81383;17.515957;1;106;0;106;100
neos-691058;1206151;234;83.065598;1;197;0;197;100
neos-693347;1206151;234;75.573465;1;676;0;676;100
neos-738098;1206151;-1099;225.695149;1;127;1;128;100
neos-777800;1206151;-80;68.220262;1;69;0;69;100
neos-780889;1206151;3421500;0;1;701;8;709;0
neos-787933;1206151;300;0;2;230;18;248;100
neos-799711;1206151;-11228065.153797;0.981255;1;1111;0;1111;100
neos-799716;1206151;4932670.661692;0.616814;1;136;0;136;100
neos-807639;1206151;492.688889;1.37037;2;11;0;11;100
neos-820879;1206151;24874.267857;62.867619;1;109;0;109;100
neos-824661;1206151;51;60.642857;2;253;2;255;100
neos-824695;1206151;42;33.8;3;98;1;99;100
neos-826224;1206151;130;70;3;204;3;207;100
neos-826650;1206151;32;109.347222;2;45;0;45;100
neos-826694;1206151;73;92.333333;3;90;2;92;100
neos-826812;1206151;70.011;151.137255;3;113;1;114;100
neos-826841;1206151;32.0082;110.679849;2;44;0;44;100
neos-827015;1206151;2.098071;332.649497;1;1830;3;1833;100
neos-827175;1206151;116.00152;83.555556;2;174;1;175;100
neos-829552;1206151;2.098071;250.649497;1;1688;1;1689;100
neos-831188;1206151;1.76772;215.733333;1;79;0;79;100
neos-847302;1206151;0;49.875712;1;77;0;77;100
neos-848198;1206151;168781;0;2;199;0;199;100
neos-848589;1206151;0;0.075873;1;1533;1;1534;100
neos-849702;1206151;0;87.382423;1;21;0;21;100
neos-850681;1206151;2087;60.770833;1;118;0;118;100
neos-860300;1206151;1666.068586;9;1;55;1;56;100
neos-872648;1206151;52.672838;0;2;1498;9;1507;8.36
neos-873061;1206151;152.431558;0;2;1242;8;1250;34.12
neos-876808;1206151;10030.533833;259.649605;2;6280;11;6291;100
neos-885086;1206151;-243;13.945733;2;213;0;213;100
neos-885524;1206151;11771.55529;9.581376;2;182;8;190;100
neos-911880;1206151;23.26;17.986476;1;2;0;2;100
neos-911970;1206151;23.26;14.456206;1;2;0;2;100
neos-913984;1206151;1000;33.522949;1;156;3;159;100
neos-914441;1206151;5660364.28377;78.177859;1;1873;1;1874;100
neos-916792;1206151;26.203596;16.256328;2;93;0;93;100
neos-932721;1206151;513000;0;3;110;3;113;100
neos-932816;1206151;513000;0;2;222;7;229;100
neos-933562;1206151;0;237.810567;1;67;0;67;100
neos-933638;1206151;462013;0;2;233;4;237;100
neos-933966;1206151;424032;0;2;174;4;178;100
neos-934278;1206151;446011;0;2;318;3;321;100
neos-935234;1206151;422081;0;2;371;1;372;100
neos-935627;1206151;23250;0;2;477;1;478;100
neos-935769;1206151;23430;0;2;406;1;407;100
neos-937511;1206151;52640;0;2;416;1;417;100
neos-937815;1206151;53700;0;2;496;1;497;100
neos-941262;1206151;51543;0;2;353;1;354;100
neos-941313;1206151;9361;325.995652;1;622;8;630;100
neos-942830;1206151;12;68.941632;1;34;0;34;100
neos-948126;1206151;51842;0;2;444;1;445;100
neos-948346;1206151;-208.675026;5.578968;5;489;19;508;100
neos-950242;1206151;2;94;2;112;1;113;100
neos-953928;1206151;-99.806667;0;3;250;4;254;0.1
neos-954925;1206151;-217.766667;0;5;1052;31;1083;8.41
neos-956971;1206151;-230.74;2.884533;4;736;15;751;100
neos-957143;1206151;-205.296379;49.220165;4;568;16;584;100
neos-957323;1206151;-211.802593;25.331104;3;346;12;358;100
neos-957389;1206151;1.5;30.754586;1;113;1;114;100
neos-960392;1206151;-238;303.359003;1;269;3;272;100
neos-983171;1206151;52602;0;2;459;1;460;100
neos-984165;1206151;52002;0;2;482;1;483;100
neos13;1206151;-126.178378;42.160092;2;234;0;234;100
neos15;1206151;144796.909577;0;2;1;0;1;79.65
neos16;1206151;429;13.142857;2;3;0;3;100
neos17;1206151;0.222688;0;2;7;0;7;48.46
neos18;1206151;11;59;3;75;0;75;100
neos2;1206151;-4717.666848;6.724359;1;8;0;8;100
neos22;1206151;413700;227;1;38;0;38;100
neos5;1206151;17.25;0;2;1;0;1;15
neos6;1206151;116.604289;27.902196;4;105;7;112;100
neos8;1206151;-2885.143864;22.041691;3;845;6;851;100
neos808444;1206151;0;221.165702;1;224;1;225;100
neos9;1206151;780;44.25;1;361;0;361;100
net12;1206151;47.514236;132.660069;3;1162;1;1163;100
netdiversion;1206151;454.4;774.4;3;9380;16;9396;100
newdano;1206151;11.724138;8.447296;1;3;0;3;100
nexp-150-20-1-5;1206151;84;0;2;39;0;39;27.27
nexp-150-20-8-5;1206151;656;0;2;86;1;87;100
nexp-50-20-1-1;1206151;34;0;2;1;0;1;17.24
nexp-50-20-4-2;1206151;120;0;2;3;0;3;69.01
nh97_potential;1206151;1461;72.75;2;6;0;6;100
nh97_tension;1206151;1438;81.583333;2;4;0;4;100
nj1;1206151;0;607;1;555;1;556;100
nj2;1206151;0;607;1;669;1;670;100
nj3;1206151;0;607;1;68327;1;68328;100
nobel-eu-DBE;1206151;7662120;0;2;89;0;89;100
noswot;1206151;-9;0;2;1;0;1;78.05
ns1111636;1206151;96.25;19.25;1;662;2;664;100
ns1116954;1206151;0;144.400486;1;816;1;817;100
ns1208400;1206151;0;89.16614;1;61;0;61;100
ns1430538;1206151;73.621609;10.155449;1;555;0;555;100
ns1456591;1206151;361.939022;19;1;117;1;118;100
ns1606230;1206151;13.225;182.603065;1;1784;0;1784;100
ns1631475;1206151;817.193748;716.662243;1;1327;1;1328;100
ns1663818;1206151;1;9.141146;1;6349;87;6436;100
ns1679495;1206151;3337055.001914;100.246101;2;49567;10;49577;100
ns1685374;1206151;-51.800913;96.218654;1;54402;1;54403;100
ns1688347;1206151;2;5.051506;1;57;0;57;100
ns1690781;1206151;-1022.785697;17.664172;2;197;1;198;100
ns1696083;1206151;2;13.475541;1;152;1;153;100
ns1758913;1206151;-1501.183256;124.830251;1;7124;6;7130;100
ns1760995;1206151;-1379.173237;142;1;21557;8;21565;100
ns1778858;1206151;-22635740;227.465047;2;268;1;269;100
ns1828997;1206151;0;75;2;832;3;835;100
ns1830653;1206151;6153;57.880312;1;141;0;141;100
ns1849932;1206151;546;6.131653;1;1047;6;1053;100
ns1853823;1206151;1172000;1386;2;53115;25;53140;100
ns1854840;1206151;1.432e+11;1139.47326;2;6993;15;7008;100
ns1856153;1206151;0;254.167528;1;154;0;154;100
ns1904248;1206151;0;854.146124;14;2665;31;2696;100
ns1905797;1206151;11.75098;19.65;1;197;1;198;100
ns1905800;1206151;6.4366;16.364665;1;43;0;43;100
ns1952667;1206151;0;10.112982;1;220;1;221;100
ns2017839;1206151;77026281754033.4;1.017799;2;7692;0;7692;100
ns2034125;1206151;0;796.623735;2;1929;0;1929;100
ns2071214;1206151;0;60.238929;1;85;0;85;100
ns2081729;1206151;4.6;0.852;2;4;0;4;100
ns2122698;1206151;62785.622771;194.641858;1;572;1;573;100
ns2124243;1206151;53998.333333;195.416667;1;455;1;456;100
ns2137859;1206151;24629;42.075016;1;790;5;795;100
ns4-pr3;1206151;36073;12;1;99;0;99;100
ns4-pr6;1206151;29145.75;8.875;1;62;0;62;100
ns4-pr9;1206151;35175;10;1;77;0;77;100
ns894236;1206151;18;199.238568;2;383;0;383;100
ns894244;1206151;16;340.564115;2;1187;1;1188;100
ns894786;1206151;14;210.712983;2;1404;2;1406;100
ns894788;1206151;7;91.946694;2;175;0;175;100
ns903616;1206151;22;385.201946;2;1032;1;1033;100
nsa;1206151;91.44794;7.482504;1;6;0;6;100
nsr8k;1206151;17500809.511815;639.929911;1;8270;3;8273;100
nsrand-ipx;1206151;646400;0;2;63;2;65;100
nu120-pr12;1206151;38070;13.695833;1;46;0;46;100
nu120-pr3;1206151;21306.442308;42.751022;1;103;0;103;100
nu120-pr9;1206151;19062.5;28.652083;1;77;0;77;100
nu25-pr12;1206151;52757.5;11.9;1;52;0;52;100
nu4-pr9;1206151;35175;22.513333;1;82;0;82;100
nu60-pr9;1206151;22850;28.383333;1;90;0;90;100
nucorsav;1206151;29.0461;81.032136;2;81642;273;81915;100
nursesched-medium-hint03;1206151;33.468485;460.316255;1;1202;3;1205;100
nursesched-medium04;1206151;411;279.979978;2;726;6;732;100
nursesched-sprint-hidden09;1206151;580.911765;177.875;2;322;2;324;100
nursesched-sprint-late03;1206151;34.254806;178.177416;1;356;1;357;100
nursesched-sprint02;1206151;129.416667;125.4375;2;230;2;232;100
nw04;1206151;16310.666667;2;1;294;5;299;100
ofi;1206151;6131846109.62063;1781.999298;135;9610;144;9754;100
ofi2;1206151;6124829152.73116;3158.688481;133;7087;189;7276;100
oocsp-racks030e6cci;1206151;0;0;1;217;2;219;0
opm2-z10-s2;1206151;-19912;0;4;24713;11;24724;41.13
opm2-z10-s4;1206151;-17801;0;4;24353;10;24363;46.49
opm2-z11-s8;1206151;-24040;0;4;49939;15;49954;44.72
opm2-z12-s14;1206151;-39815;0;6;120332;32;120364;38.07
opm2-z12-s7;1206151;-39769;0;5;111118;23;111141;39.3
opm2-z12-s8;1206151;-34893;0;5;111317;24;111341;40.39
opm2-z6-s1;1206151;-2356;0;3;317;1;318;62.01
opm2-z7-s2;1206151;-7132;0;4;776;2;778;30.62
opm2-z7-s8;1206151;-6856;0;4;871;2;873;39.01
opm2-z8-s0;1206151;-8004;0;3;3717;3;3720;49.26
opt1217;1206151;-20.02139;8.22549;1;1;0;1;100
osorio-cta;1206151;0;3.5e-05;1;57;0;57;100
p0201;1206151;6875;20;1;1;0;1;100
p100x588b;1206151;58977;0;2;1;0;1;23.18
p200x1188c;1206151;15747;0;2;1;0;1;4.44
p2756;1206151;2718;2.345553;2;5;0;5;100
p500x2988;1206151;72594;0;2;30;0;30;1.06
p500x2988c;1206151;17212;0;2;32;0;32;13.13
p500x2988d;1206151;6;0;2;30;0;30;0
p6b;1206151;-53;0;3;38;0;38;15.87
p80x400b;1206151;45896;0;2;1;0;1;15.7
pb-fit2d;1206151;-22372.476239;842.898884;1;6838;11;6849;100
pb-gfrd-pnc;1206151;8316.011268;30.700616;1;121;1;122;100
pb-grow22;1206151;-449681.200587;122.632175;1;436;1;437;100
pb-market-split8-70-4;1206151;0;2.197219;1;0;0;0;100
pb-simp-nonunif;1206151;6;513.5;2;3841;54;3895;100
peg-solitaire-a3;1206151;1;289.311002;1;385;0;385;100
pg;1206151;-11098.657382;17.215049;2;5;0;5;100
pg5_34;1206151;-16012.248077;18.476238;2;6;0;6;100
physiciansched3-3;1206151;2432694.766159;1299.771515;17;60097;128;60225;100
physiciansched3-4;1206151;1124678.224456;1152.371387;12;36187;70;36257;100
physiciansched5-3;1206151;5180;1064.20702;3;1424;4;1428;100
physiciansched6-1;1206151;7500;756.571528;2;749;12;761;100
physiciansched6-2;1206151;43012.5;757.225;2;651;11;662;100
pigeon-08;1206151;-8000;8.25974;1;2;0;2;100
pigeon-10;1206151;-10000;13.559596;1;2;0;2;100
pigeon-11;1206151;-11000;16.690909;1;3;0;3;100
pigeon-12;1206151;-12000;21.818182;1;3;0;3;100
pigeon-13;1206151;-13000;24;1;4;0;4;100
pigeon-16;1206151;-16000;74.018182;1;5;0;5;100
pigeon-19;1206151;-19000;59.036364;1;32;0;32;100
pigeon-20;1206151;-20000;62.509091;1;33;0;33;100
piperout-03;1206151;68814.99759;435.327133;6;429;3;432;100
piperout-08;1206151;99128.924471;558.342366;32;433;16;449;100
piperout-27;1206151;6970;1154.464464;12;474;7;481;100
piperout-d20;1206151;25533.842105;676.796097;2;1077;2;1079;100
piperout-d27;1206151;7083.116279;1022.542306;2;1456;2;1458;100
pk1;1206151;0;2.794444;1;0;0;0;100
polygonpack3-15;1206151;-96519350.40932;30.691342;3;1402;5;1407;100
polygonpack4-10;1206151;-93676953.4701;20.42385;3;431;2;433;100
polygonpack4-15;1206151;-114052801.79086;40.321265;3;1368;5;1373;100
polygonpack4-7;1206151;-75324958.8742;9.351219;3;220;1;221;100
polygonpack5-15;1206151;-42382234.50354;24.151449;3;1620;7;1627;100
pp08a;1206151;15000;0;2;1;0;1;100
pp08aCUTS;1206151;16630.402442;0;2;2;0;2;100
probportfolio;1206151;5;15.184084;2;3;0;3;100
prod1;1206151;-100;6.72495;2;1;0;1;100
prod2;1206151;-100;4.433874;2;1;0;1;100
proteindesign121hz512p19;1206151;3197.772133;67.38213;1;17579;139;17718;100
proteindesign121hz512p9;1206151;1423.904449;61.920249;1;756;8;764;100
proteindesign121pgb11p9;1206151;1173.710433;49.777201;1;576;6;582;100
proteindesign122trx11p8;1206151;1720.461105;46.268597;1;556;5;561;100
protfold;1206151;0;35;2;16;0;16;100
pw-myciel4;1206151;0;65.596829;6;34;0;34;100
pythago7824;1206151;0;580.777778;6;764;2;766;100
pythago7825;1206151;0;586.777778;8;851;3;854;100
qap10;1206151;332.566228;55;1;366;0;366;100
qiu;1206151;1805.177143;0;2;3;0;3;100
qnet1;1206151;98035.87;7.221868;2;12;0;12;100
qnet1_o;1206151;96705.12;0;2;5;0;5;100
queens-30;1206151;-30;0;3;186;1;187;25
r4l4-02-tree-bounds-50;1206151;510876207;651.016667;2;50;0;50;100
r50x360;1206151;2016;0;2;1;0;1;21.96
r80x800;1206151;5520;0;2;1;0;1;3.53
radiationm18-12-05;1206151;17554.5;196.038066;1;193;1;194;100
radiationm40-10-02;1206151;155306.7;933.533;1;1103;7;1110;100
rail01;1206151;-92.0873;2555.823708;1;10952;6;10958;100
rail02;1206151;-206.6102;3001.898333;1;129068;13;129081;100
rail03;1206151;-920.273762;12426.061971;1;170697;40;170737;100
rail507;1206151;216;0;3;658;11;669;24.14
railway_8_1_0;1206151;397;64.534158;3;10;0;10;100
ramos3;1206151;440;0;3;1394;0;1394;100
ran12x21;1206151;4080;0;2;0;0;0;11.35
ran13x13;1206151;3521;0;2;0;0;0;8.27
ran14x18-disj-8;1206151;12451.012696;0;2;22;0;22;100
ran14x18;1206151;4265;0;2;0;0;0;14.9
ran16x16;1206151;4333;0;2;0;0;0;13.34
rd-rplusc-21;1206151;100;4.122769;1;541;1;542;100
reblock115;1206151;-39365983.337347;271.565472;1;191;0;191;100
reblock166;1206151;-886882876.965829;382.279623;1;491;0;491;100
reblock354;1206151;-39640995.765204;569.832903;3;840;1;841;100
reblock420;1206151;-886535897.522137;986.979676;1;2505;0;2505;100
reblock67;1206151;-39339910.923037;159.950504;1;53;0;53;100
rfds-4-days;1206151;-1158940.978167;54.113757;1;66149;27;66176;100
rlp1;1206151;13.244444;9.961905;1;1;0;1;100
rmatr100-p10;1206151;360.593308;9.692735;1;194;0;194;100
rmatr100-p5;1206151;762.040054;5;1;525;0;525;100
rmatr200-p10;1206151;1550.620783;10;1;11306;0;11306;100
rmatr200-p20;1206151;688.357943;19.982266;1;4729;0;4729;100
rmatr200-p5;1206151;3283.653831;5;1;12179;0;12179;100
rmine10;1206151;-1926.821009;886.351115;2;3973;2;3975;100
rmine11;1206151;-2511.986814;1275.572328;14;11162;20;11182;100
rmine13;1206151;-3504.619914;1108.274293;2;41883;6;41889;100
rmine14;1206151;-4308.869811;2215.505904;7;97837;25;97862;100
rmine15;1206151;-5041.420189;4256.942532;4;180099;21;180120;100
rmine6;1206151;-436.021627;48.709031;12;144;1;145;100
rocI-3-11;1206151;-111086.671772;559.283036;1;50;0;50;100
rocI-4-11;1206151;-11111086.671772;810.679039;1;80;0;80;100
rocII-10-11;1206151;-11.974865;306.103805;1;534;2;536;100
rocII-4-11;1206151;-11.937162;82.5;1;156;1;157;100
rocII-5-11;1206151;-11.94973;122.235744;1;185;1;186;100
rocII-7-11;1206151;-11.964093;207.33219;1;340;1;341;100
rocII-8-11;1206151;-11.968581;244.702313;1;464;2;466;100
rocII-9-11;1206151;-11.972072;276.465408;1;536;2;538;100
rococoB10-011000;1206151;8350.199468;49.840978;1;127;0;127;100
rococoC10-001000;1206151;7515.271029;14.886765;1;59;0;59;100
rococoC11-010100;1206151;8773.206543;49.89581;1;158;0;158;100
rococoC11-011100;1206151;9024.205406;56.60339;1;133;0;133;100
rococoC12-010001;1206151;26787.292147;50.829414;1;219;1;220;100
rococoC12-111000;1206151;27337.357381;53.501346;1;268;0;268;100
roi2alpha3n4;1206151;-80.526722;7.807845;2;672;8;680;100
roi5alpha10n8;1206151;-87.787142;16;2;2082;26;2108;100
roll3000;1206151;11097.127677;46.77651;3;34;0;34;100
rout;1206151;981.864286;9.898077;1;1;0;1;100
rpp22falsei;1206151;0;0;1;41;0;41;0
rvb-sub;1206151;11.206514;4.571429;1;741;5;746;100
s100;1206151;-0.171097;43.263533;1;25477;18;25495;100
s1234;1206151;0.361925;1.578294;6;1703;2;1705;100
s250r10;1206151;-0.166732;112.777088;2;10080;29;10109;100
s55;1206151;-22.151773;0;1;1754;4;1758;0
s82;1206151;-33.833613;638.111555;2;206231;169;206400;100
satellites1-25;1206151;-20;46.054099;1;159;0;159;100
satellites2-25;1206151;-30;232.549845;1;5164;2;5166;100
satellites2-40;1206151;-30;128.145498;1;16222;2;16224;100
satellites2-60-fs;1206151;-30;502.252135;1;2573;1;2574;100
satellites2-60;1206151;-30;313.609113;1;17927;2;17929;100
satellites3-25;1206151;-39;981.495523;1;206939;5;206944;100
satellites3-40-fs;1206151;-39;956.482639;1;28764;4;28768;100
satellites3-40;1206151;-39;963.650088;1;211076;6;211082;100
savsched1;1206151;22586.49862;0;2;119947;36;119983;100
scpj4scip;1206151;183;0;3;1286;27;1313;41.86
scpk4;1206151;389;0;3;2705;26;2731;21.18
scpl4;1206151;360;0;3;4944;52;4996;36.88
scpm1;1206151;774;0;3;45698;127;45825;37.97
scpn2;1206151;741;0;3;72271;249;72520;38.76
sct1;1206151;-218.139003;91.32546;1;1383;0;1383;100
sct2;1206151;-231.116964;15.708827;1;64;0;64;100
sct31;1206151;-31.962662;31.547827;1;202;0;202;100
sct32;1206151;-62.990833;53.144038;1;749;0;749;100
sct5;1206151;-228.176552;31.924007;2;275;2;277;100
seqsolve1;1206151;4376.282987;371.073706;19;4700;185;4885;100
seqsolve2short4288;1206151;4.45;440.788269;4;2846;40;2886;100
seqsolve3short4288excess384;1206151;-46401.234768;425.509375;7;13173;63;13236;100
set1ch;1206151;110241.5;0;2;1;0;1;100
set3-09;1206151;1263.077974;49.748593;3;63;0;63;100
set3-10;1206151;788.890655;50.61299;3;41;0;41;100
set3-15;1206151;8364.040745;53.876403;3;46;0;46;100
set3-16;1206151;9916.808562;58.149187;3;42;0;42;100
set3-20;1206151;10347.381087;53.849605;3;43;0;43;100
seymour-disj-10;1206151;320.000002;2e-06;3;1803;1;1804;100
seymour;1206151;454;0;3;213;1;214;7.33
seymour1;1206151;422.819841;0;3;206;0;206;2.94
shiftreg1-4;1206151;131.656032;300.178571;1;49;0;49;100
shiftreg2-7;1206151;206.733052;275.753282;1;70;0;70;100
shiftreg5-1;1206151;520.839888;632.617991;1;321;0;321;100
shipsched;1206151;0;2.147365;5;133;2;135;100
shipschedule3shipsi;1206151;-265650;0;1;37;0;37;0
shipschedule6shipsmixi;1206151;-301650;0;1;58;0;58;0
shipschedule8shipsmixuci;1206151;-401100;0;1;70;1;71;0
shs1014;1206151;22137.410363;350.541667;1;176333;20;176353;100
shs1042;1206151;9455.525826;684.883411;1;66560;20;66580;100
siena1;1206151;10163179.229002;146.859338;1;1749;2;1751;100
sing11;1206151;18640171.224643;331.879469;1;8199;7;8206;100
sing161;1206151;19071259.113927;996.464534;1;64062;35;64097;100
sing17;1206151;35483848.876514;554.751047;1;30939;22;30961;100
sing2;1206151;17150914.71694;252.506822;1;1563;1;1564;100
sing245;1206151;25024015.754083;519.079791;1;11922;11;11933;100
sing326;1206151;7717674.801189;203.886687;1;2642;3;2645;100
sing359;1206151;22534478.962498;1259.613224;1;82228;36;82264;100
sing44;1206151;8102513.2194;177.330369;1;3169;2;3171;100
sing5;1206151;18418516.013137;272.410096;1;3501;7;3508;100
snip10x10-35r1budget17;1206151;30;2.533333;1;444;0;444;100
snp-02-004-104;1206151;548044802.97509;10.217187;2;4228;1;4229;100
snp-04-052-052;1206151;728196432.049806;735.582559;2;3886;2;3888;100
snp-06-004-052;1206151;1787138156.58097;33.734354;2;6632;1;6633;100
snp-10-004-052;1206151;5842625068.20526;48.106063;2;14281;2;14283;100
snp-10-052-052;1206151;5842626434.04626;1694.316668;2;16164;5;16169;100
sorrell3;1206151;-11;0;3;751;10;761;31.25
sorrell4;1206151;-16;0;3;2938;31;2969;33.33
sorrell7;1206151;-138;0;3;422;5;427;29.59
sorrell8;1206151;-259;0;3;81;1;82;26
sp150x300d;1206151;71;0;2;1;0;1;2.9
sp97ar;1206151;807607302.399999;1.342794;4;520;8;528;100
sp97ic;1206151;597287696.727546;1.277104;3;383;6;389;100
sp98ar;1206151;642003743.188383;1.613817;16;607;39;646;100
sp98ic;1206151;633805370.656431;1.781976;4;402;8;410;100
sp98ir;1206151;265679354.122102;8.206982;4;75;1;76;100
splice1k1;1206151;-1646.777979;8.512635;1;18267;7;18274;100
splice1k1i;1206151;-1654;0;1;195;6;201;0
square23;1206151;8.333333;12.444444;1;137;3;140;100
square31;1206151;8.5;13.75;1;753;15;768;100
square37;1206151;8.666667;15;1;2512;33;2545;100
square41;1206151;8.839612;15.068891;1;4130;48;4178;100
square47;1206151;8.755814;15.976744;1;6441;102;6543;100
stoch-vrpvrp-s5v2c8vrp-v2c8i;1206151;0;119.181818;1;32;0;32;100
stockholm;1206151;173;0;2;493;0;493;38.4
stp3d;1206151;604.886283;537.229946;2;24907;18;24925;100
sts405;1206151;357;0;2;513;1;514;0
sts729;1206151;665;0;2;3187;4;3191;0
supportcase1;1206151;20078;0.020624;2;313;4;317;100
supportcase10;1206151;3.383924;1850.997936;1;10000;3;10003;100
supportcase11;1206151;-25.979452;762069;1;306793;492;307285;100
supportcase12;1206151;-7609.533054;55.569104;1;1608;1;1609;100
supportcase14;1206151;272;9.894737;1;4;0;4;100
supportcase16;1206151;272;9;1;2;0;2;100
supportcase17;1206151;0;88.929601;2;11;0;11;100
supportcase18;1206151;87;9.141806;2;62;0;62;100
supportcase19;1206151;12677206;370.390975;1;26369;63;26432;100
supportcase2;1206151;0;7.75;1;10118;49;10167;100
supportcase20;1206151;2442.144012;4.88286;1;20;0;20;100
supportcase23;1206151;-12952;674.436182;1;1730;0;1730;100
supportcase25;1206151;0.036932;10.829622;1;103;0;103;100
supportcase26;1206151;1288.102161;0.009948;2;2;0;2;100
supportcase27i;1206151;0;0.028235;1;1;0;1;100
supportcase3;1206151;0;754.600046;3;233;1;234;100
supportcase30;1206151;0;102.85702;1;65;0;65;100
supportcase31;1206151;-1120655.076;0;3;1907;77;1984;69.88
supportcase33;1206151;-468.46299;67.367519;2;530;3;533;100
supportcase34;1206151;72.664116;328.063419;1;1223;3;1226;100
supportcase35;1206151;77847.333333;96;2;127;0;127;100
supportcase37;1206151;-5865.764096;28.093523;2;817;0;817;100
supportcase39;1206151;-1062330.369524;22.808785;5;136;9;145;100
supportcase4;1206151;0;537.153071;3;178;0;178;100
supportcase40;1206151;22536.483379;19;1;238;0;238;100
supportcase41;1206151;28;24.340373;5;288;1;289;100
supportcase42;1206151;7.343539;48.081295;1;1638;2;1640;100
supportcase43;1206151;0;48.147044;2;49116;3;49119;100
supportcase6;1206151;45090.732163;30.239669;1;1594;9;1603;100
supportcase7;1206151;-2396.218213;53.14731;2;2064;0;2064;100
swath;1206151;334.496858;2.2;1;43;0;43;100
swath1;1206151;334.496858;0.6;1;40;0;40;100
swath2;1206151;334.496858;0.7;1;38;0;38;100
swath3;1206151;334.496858;0.8;1;38;0;38;100
t1717;1206151;134531.021428;79.098998;1;289;4;293;100
t1722;1206151;98815.407611;52.399108;1;154;2;156;100
ta1-UUM;1206151;3693674.556772;4.190418;1;5;0;5;100
ta2-UUE;1206151;41427354.755773;0.680983;2;170;0;170;100
tanglegram1;1206151;0;146;1;261;2;263;100
tanglegram2;1206151;0;74;1;42;0;42;100
tanglegram4;1206151;0;214;1;860;3;863;100
tanglegram6;1206151;0;100;1;64;0;64;100
tbfp-bigm;1206151;-178.153988;30;1;277;0;277;100
tbfp-network;1206151;23.261535;31;1;821;3;824;100
Test3;1206151;2669532.692462;22.368722;2;265;3;268;100
thor50dday;1206151;204179;0;2;220;4;224;100
timtab1;1206151;1234325.333333;18.45;2;1;0;1;100
timtab1CUTS;1206151;613590.095426;35.885811;2;3;0;3;100
timtab2;1206151;1487304.333333;29.783333;2;1;0;1;100
tokyometro;1206151;11100;251.050363;2;66;0;66;100
toll-like;1206151;0;339.5;1;59;0;59;100
tpl-tub-ss16;1206151;8052373.477492;2148.906605;2;90546;195;90741;100
tpl-tub-ws1617;1206151;10498468.058836;2262.455897;2;122194;281;122475;100
tr12-30;1206151;188435.464884;3.580258;2;1;0;1;100
traininstance2;1206151;0;641.708827;2;56;0;56;100
traininstance6;1206151;0;381.122112;2;45;0;45;100
transportmoment;1206151;-70929535815.38;783.890174;2;198;0;198;100
trento1;1206151;5182758.848056;76.181959;1;547;0;547;100
triptim1;1206151;22.868087;2090.375;1;9597;3;9600;100
triptim2;1206151;10.866359;807.547954;1;10191;3;10194;100
triptim3;1206151;13.511741;809.069096;1;11748;4;11752;100
triptim4;1206151;9.207022;595.626838;1;11062;3;11065;100
triptim7;1206151;2336.732602;612.910017;2;11854;6;11860;100
triptim8;1206151;2336.754853;584.347661;2;12149;6;12155;100
tw-myciel4;1206151;3.838028;125.987676;4;183;0;183;100
uc-case11;1206151;611267.013003;118.928617;1;2947;0;2947;100
uc-case3;1206151;7181.264177;95.341586;1;2136;0;2136;100
uccase10;1206151;38988.693469;403.985961;1;2943;1;2944;100
uccase12;1206151;11507.285324;38.32;1;2307;1;2308;100
uccase7;1206151;26527.789654;162.379998;1;3737;0;3737;100
uccase8;1206151;11142.163196;63.982247;1;2608;0;2608;100
uccase9;1206151;10819.582997;76.021209;1;4249;0;4249;100
uct-subprob;1206151;242;56.889019;1;43;0;43;100
umts;1206151;91618146.215272;77.667697;2;53;0;53;100
unitcal_7;1206151;19387754.848556;143.965819;2;1080;0;1080;100
usAbbrv-8-25_70;1206151;95;138.115058;3;44;0;44;100
usafa;1206151;11.961749;2881.373487;2;52577;165;52742;100
v150d30-2hopcds;1206151;52;0;3;108;1;109;26.83
van;1206151;1.72352;5.404444;1;2329;0;2329;100
var-smallemery-m6j6;1206151;-156.056268;90.190835;2;1145;7;1152;100
vpm2;1206151;13.372866;5.698001;2;18;0;18;100
vpphard;1206151;0;125.275;1;227;3;230;100
vpphard2;1206151;0;224.687229;1;622;11;633;100
wachplan;1206151;-9;69.499445;1;39;0;39;100
wnq-n100-mw99-14;1206151;198.078947;81.026316;3;4838;30;4868;100
xmas10-2;1206151;-548.904684;180.189643;1;220;0;220;100
xmas10;1206151;-449.397905;132.337672;7;198;0;198;100
z26;1206151;-967;0;3;2749;48;2797;18.53
zeil;1206151;813.510308;818.357568;2;88096;14;88110;100
zib54-UUE;1206151;19164366;0;2;46;0;46;85.45
