Instance;Seed;Cost;Fractionality;Rounds;LPtime(ms);ZItime(ms);LP+ZItime(ms);Gap(%)
10teams;1206151;917;36.45783;1;30;0;30;100
22433;1206151;21552.708079;24.962328;5;7;0;7;100
23588;1206151;8342.863244;17.617619;4;3;0;3;100
2club200v15p5scn;1206151;-96.055556;38.611111;7;121;3;124;100
30n20b8;1206151;5530;16.175931;2;81;1;82;100
30_70_45_05_100;1206151;132;0;6;1002;4;1006;100
30_70_45_095_100;1206151;57;0;5;945;2;947;100
30_70_45_095_98;1206151;575;0;6;826;4;830;100
50v-10;1206151;1493601.476062;0;2;4;0;4;100
a1c1s1;1206151;20912.873333;0.041667;2;34;0;34;100
a2c1s1;1206151;20866.0825;0;2;34;0;34;91.62
ab51-40-100;1206151;-6462960122;0;3;851;1;852;37.98
ab67-40-100;1206151;-7069213256;0;3;2950;1;2951;36.8
ab69-40-100;1206151;-7004957457;0;3;2056;1;2057;37.38
ab71-20-100;1206151;-6512126462;0;3;227;1;228;37.51
ab72-40-100;1206151;-6898618453.00001;0;3;802;2;804;38.33
academictimetablebig;1206151;32;1997.079231;2;3302;33;3335;100
academictimetablesmall;1206151;0;324.85601;2;269;3;272;100
acc-tight2;1206151;0;129.034401;1;35;0;35;100
acc-tight4;1206151;0;135.271717;1;56;0;56;100
acc-tight5;1206151;0;121.269585;1;276;0;276;100
acc-tight6;1206151;0;123.251301;1;250;0;250;100
adult-max5features;1206151;0.081316;0.266955;1;882;5;887;100
adult-regularized;1206151;0.077684;0.234052;1;3691;3;3694;100
aflow30a;1206151;983.167425;6.510845;1;5;0;5;100
aflow40b;1206151;1005.664817;8.247724;1;21;0;21;100
air03;1206151;338864.25;11.875;1;59;0;59;100
air04;1206151;55535.436388;52.288553;1;216;0;216;100
air05;1206151;25877.609268;46.215654;1;153;0;153;100
aligninq;1206151;2755;40.921868;7;16;0;16;100
allcolor10;1206151;6;749.769481;2;150;1;151;100
allcolor58;1206151;42;3883.60245;1;1206;6;1212;100
amaze22012-03-15i;1206151;0;0;1;40;1;41;0
amaze22012-06-28i;1206151;0;0;1;23;0;23;0
amaze22012-07-04i;1206151;0;0;1;27;0;27;0
app1-1;1206151;-2;0.179678;3;59;0;59;100
app1-2;1206151;-23;1e-06;2;4175;1;4176;100
app2-1;1206151;19298.5;0;2;32;0;32;0.02
app2-2;1206151;219402.5;0;3;1;0;1;3.47
app3;1206151;5627412.287938;3.142492;1;36;0;36;100
arki001;1206151;7579599.807787;17.164714;1;35;0;35;100
assign1-10-4;1206151;353.992926;52;1;39;0;39;100
assign1-5-8;1206151;183.362555;24;1;2;0;2;100
atlanta-ip;1206151;81.243206;325.689509;3;4823;6;4829;100
atm20-100;1206151;2141734.684878;124.301066;2;93;0;93;100
australia-abs-cta;1206151;0;39.202778;1;81;0;81;100
b-ball;1206151;-1.818182;4.818182;1;0;0;0;100
b1c1s1;1206151;69966.45;0;2;34;0;34;100
b2c1s1;1206151;70651.01;0;2;40;0;40;100
bab1;1206151;-286923.824223;50.52;1;311;5;316;100
bab2;1206151;-350926.440227;560.525267;2;8732;23;8755;100
bab3;1206151;-579370.271196;518.325237;2;33311;47;33358;100
bab5;1206151;-111134.599976;185.90025;2;514;2;516;100
bab6;1206151;-224575.783183;667.210836;2;5848;16;5864;100
bc;1206151;13.063318;0.063318;2;100;0;100;100
bc1;1206151;6.45558;0.016336;2;107;0;107;100
beasleyC1;1206151;102;0;2;2;0;2;20
beasleyC2;1206151;232;0;2;3;0;3;61.11
beasleyC3;1206151;958;0;2;3;0;3;27.06
beavma;1206151;407840.4;0;3;1;0;1;6.41
berlin;1206151;1741;0;2;28;0;28;66.76
berlin_5_8_0;1206151;52;70.73383;3;5;0;5;100
bg512142;1206151;323992.007013;52.989642;3;27;0;27;100
biella1;1206151;3060037.430763;98.771008;1;262;0;262;100
bienst1;1206151;11.724138;4.390524;1;2;0;2;100
bienst2;1206151;11.724138;5.390524;1;2;0;2;100
binkar10_1;1206151;6637.188027;9.084811;1;7;0;7;100
blend2;1206151;7.489992;0.492283;2;0;0;0;100
bley_xl1;1206151;265.699568;343.861165;6;21647;24;21671;100
bley_xs1;1206151;213538830.272187;107.27048;3;137;0;137;100
bley_xs1noM;1206151;260783449.512445;78.38821;8;114;2;116;100
bley_xs2;1206151;48593009.277766;66.02141;2;21;0;21;100
blp-ar98;1206151;14303.194003;9.189386;9;112;15;127;100
blp-ic97;1206151;6123.238237;3.473359;16;83;16;99;100
blp-ic98;1206151;14141.050706;0.1;4;117;6;123;100
blp-ir98;1206151;5639.818879;2.497817;2;41;1;42;100
bmocbd;1206151;-32041010095048.5;0;1;722;6;728;0
bmocbd2;1206151;-31953009810558.2;0;1;696;6;702;0
bmocbd3;1206151;45423160355.8155;0;3;16258;16;16274;100
bmoipr2;1206151;-46628940.711141;0.184434;3;80;1;81;100
bnatt350;1206151;0;93.793362;6;66;1;67;100
bnatt400;1206151;0;109.069591;9;75;2;77;100
bppc4-08;1206151;51.59;9.776528;1;15;0;15;100
bppc6-02;1206151;108.34;11.886994;1;151;1;152;100
bppc6-06;1206151;200.633333;14.947367;1;158;0;158;100
bppc8-02;1206151;486.5;3.204377;1;1;0;1;100
bppc8-09;1206151;444.436047;5.98123;1;4;0;4;100
brasil;1206151;31819;0;2;29;0;29;100
brazil3;1206151;2;656.675844;1;1006;1;1007;100
breastcancer-regularized;1206151;0.00046;0.002809;1;8;0;8;100
bts4-cta;1206151;33524.637606;1130;1;578;0;578;100
buildingenergy;1206151;33246.215059;1468.85;2;16072;4;16076;100
cap6000;1206151;-2446875;0;3;47;1;48;0.18
cbs-cta;1206151;0;27.74603;1;107;0;107;100
cdc7-4-3-2;1206151;-232;0;3;36618;5;36623;19.44
chromaticindex1024-7;1206151;4;16002.682953;2;2410;10;2420;100
chromaticindex128-5;1206151;4;2021.163699;2;127;1;128;100
chromaticindex256-8;1206151;4;4069.477083;2;366;2;368;100
chromaticindex32-8;1206151;4;504.8875;2;17;0;17;100
chromaticindex512-7;1206151;4;8183.527137;2;1049;4;1053;100
ci-s4;1206151;4.963809;19.526141;2;60;0;60;100
circ10-3;1206151;140;155.071429;1;182;1;183;100
cmflsp40-24-10-7;1206151;52605868.952858;70.70093;3;367;0;367;100
cmflsp40-36-2-10;1206151;72898024.959478;295.649246;3;764;0;764;100
cmflsp50-24-10-4;1206151;64492612.641644;81.236085;3;350;0;350;100
cmflsp50-24-8-8;1206151;59814378.749021;131.86946;3;346;0;346;100
cmflsp60-36-2-6;1206151;97887903.946142;370.689759;3;1734;0;1734;100
CMS750_4;1206151;250;258.584847;3;116;1;117;100
co-100;1206151;1250429.774879;9.799423;2;257;19;276;100
cod105;1206151;-8;0;3;467;1;468;33.33
comp07-2idx;1206151;0;139.65;2;1260;2;1262;100
comp08-2idx;1206151;0;189.588538;3;168;1;169;100
comp12-2idx;1206151;11;251.466598;3;1266;2;1268;100
comp16-3idx;1206151;4;720.391848;1;8392;2;8394;100
comp21-2idx;1206151;0;197.95;2;834;1;835;100
control30-3-2-3;1206151;-20763026.787568;27.97054;1;5;0;5;100
core2536-691;1206151;796;0;3;1430;3;1433;15.53
core2586-950;1206151;1150;0;3;1017;3;1020;21.31
core4284-1064;1206151;1312;0;3;4783;6;4789;23.42
core4872-1529;1206151;1869;0;3;2875;6;2881;22.16
cost266-UUE;1206151;42001606.28;0;2;84;0;84;67.01
cov1075;1206151;56;0;3;6;0;6;100
cryptanalysiskb128n5obj16;1206151;0;7174.215397;2;851;8;859;100
csched007;1206151;269.251587;22.185714;1;42;0;42;100
csched008;1206151;171;19.560203;1;10;0;10;100
csched010;1206151;332.422727;19.770202;1;53;0;53;100
cvrpa-n64k9vrpi;1206151;0;206.143617;1;341;2;343;100
cvrpb-n45k5vrpi;1206151;0;154.740458;1;151;1;152;100
cvrpp-n16k8vrpi;1206151;0;50.204545;1;35;0;35;100
cvrpsimple2i;1206151;0;19.85;1;2;0;2;100
cvs08r139-94;1206151;-24;0;3;14;0;14;79.31
cvs16r106-72;1206151;-10;0;3;31;0;31;87.65
cvs16r128-89;1206151;-11;0;3;34;0;34;88.66
cvs16r70-62;1206151;-5;0;3;28;0;28;88.1
cvs16r89-60;1206151;-7;0;3;27;0;27;89.23
d10200;1206151;12425.583005;34.236879;1;49;0;49;100
d20200;1206151;12229.625788;62.339279;1;324;0;324;100
dale-cta;1206151;0;0.004764;1;321;0;321;100
dano3mip;1206151;576.23162;15.294513;1;1665;0;1665;100
dano3_3;1206151;576.23162;1.932181;1;1780;0;1780;100
dano3_5;1206151;576.23162;2.871834;1;1716;0;1716;100
danoint;1206151;62.63728;5.819184;1;13;0;13;100
dc1c;1206151;1754946.863638;139.834191;1;272;1;273;100
dc1l;1206151;522111659.267954;0;3;1159;16;1175;100
dcmulti;1206151;184858.396836;12.823814;3;3;0;3;100
decomp1;1206151;-120;98;1;45;0;45;100
decomp2;1206151;-160;93.138889;1;52;0;52;100
dfn-bwin-DBE;1206151;797567.4;0;2;36;0;36;100
dfn-gwin-UUM;1206151;27467.257235;5.653537;1;1;0;1;100
dg012142;1206151;5895516.340434;39.442147;5;178;0;178;100
diameterc-mstc-v20a190d5i;1206151;291;56.7;1;33;0;33;100
diameterc-msts-v40a100d5i;1206151;324;100.121212;1;32;0;32;100
disctom;1206151;-5000;51.166667;1;204;0;204;100
disktom;1206151;-5000;51.166667;1;224;0;224;100
dolom1;1206151;6556066.068315;110.606017;1;464;1;465;100
drayage-100-12;1206151;21458.311901;45.375525;1;58;0;58;100
drayage-100-23;1206151;11714.141979;44.659861;1;128;0;128;100
drayage-25-23;1206151;11714.141979;44.421956;1;128;0;128;100
drayage-25-27;1206151;26785.797043;41.335416;1;72;0;72;100
drayage-25-32;1206151;32519.997253;41.203921;1;65;0;65;100
ds-big;1206151;86.820068;30.669231;1;7955;21;7976;100
ds;1206151;57.234565;33.463549;1;1298;7;1305;100
dws008-01;1206151;708.876687;16.484655;2;57;0;57;100
dws008-03;1206151;717.896796;9.217365;2;130;1;131;100
dws012-01;1206151;3450.401707;26.235704;2;120;1;121;100
dws012-02;1206151;1584.690892;16.166549;2;210;2;212;100
dws012-03;1206151;1998.123968;18.170643;2;316;4;320;100
eil33-2;1206151;811.278996;3.61563;1;36;0;36;100
eilA101-2;1206151;803.373888;7.408683;1;888;6;894;100
eilB101;1206151;1075.247691;12.807028;1;21;0;21;100
eilC76-2;1206151;725.754458;7.780208;1;283;2;285;100
ej;1206151;1;0.243844;1;0;0;0;100
elitserienhandball11i;1206151;0;1421.352265;1;243;1;244;100
elitserienhandball13i;1206151;0;1357.692232;1;257;1;258;100
elitserienhandball14i;1206151;0;1543.7577;1;278;1;279;100
elitserienhandball3i;1206151;0;1525.315516;1;254;1;255;100
enlight13;1206151;0;0.5;1;0;0;0;100
enlight15;1206151;0;0.5;1;0;0;0;100
enlight8;1206151;0;0.5;1;0;0;0;100
enlight_hard;1206151;0;14.5;1;0;0;0;100
eva1aprime5x5opt;1206151;-497.247729;0.959853;1;364;0;364;100
eva1aprime6x6opt;1206151;-495.49243;9.408398;1;1747;0;1747;100
ex10;1206151;100;100;1;17556;6;17562;100
ex1010-pi;1206151;304;0;3;685;3;688;29.36
ex9;1206151;81;81;1;1677;3;1680;100
exp-1-500-5-5;1206151;97666.305541;4.045842;2;2;0;2;100
f2000;1206151;1383;1280;2;3617;0;3617;100
f2gap201600;1206151;76429.862296;1.402159;1;3;0;3;100
f2gap401600;1206151;82274.237434;1.19002;1;4;0;4;100
f2gap40400;1206151;20650.898154;3.25358;1;1;0;1;100
f2gap801600;1206151;86570.120867;5.266841;1;5;0;5;100
fast0507;1206151;214;0;3;580;14;594;22.99
fastxgemm-n2r6s0t2;1206151;27;9;1;37;0;37;100
fastxgemm-n2r7s4t1;1206151;27;9;1;36;0;36;100
fastxgemm-n3r21s3t6;1206151;84;27;1;2326;0;2326;100
fastxgemm-n3r22s4t6;1206151;84;27;1;2653;0;2653;100
fastxgemm-n3r23s5t6;1206151;84;27;1;2571;0;2571;100
fhnw-binpack4-48;1206151;0;333.285714;2;133;0;133;100
fhnw-binpack4-58;1206151;0;467.321429;2;156;1;157;100
fhnw-binpack4-77;1206151;0;207.310714;2;114;0;114;100
fhnw-binschedule0;1206151;12632.888779;685.581929;3;11517;38;11555;100
fhnw-binschedule2;1206151;1706.886254;154.751416;3;171;3;174;100
fhnw-schedule-paira100;1206151;-36.643681;5.147307;2;123;0;123;100
fhnw-schedule-paira200;1206151;-73.826479;8.938667;2;277;2;279;100
fhnw-schedule-paira400;1206151;-146.941079;19.26431;2;1164;11;1175;100
fhnw-schedule-pairb200;1206151;-73.826479;516.184695;2;1135;5;1140;100
fhnw-schedule-pairb400;1206151;-146.941079;2338.646383;2;7417;24;7441;100
fhnw-sq2;1206151;0;15.527645;1;4;0;4;100
fiball;1206151;137.069168;68.996028;1;122;1;123;100
fiber;1206151;1023943.76;9.839127;2;3;0;3;100
fillomino7x7-0i;1206151;0;0;1;29;0;29;0
fixnet6;1206151;12170;0;2;1;0;1;100
fjspeasy01i;1206151;216;0;1;36;0;36;0
flugpl;1206151;1167185.725592;3.538918;1;0;0;0;100
g200x740;1206151;45614;0;2;2;0;2;2.93
g200x740i;1206151;44069;0;2;2;0;2;46.48
gasprod1-1;1206151;4539.90753;51.5198;7885;780;6267;7047;100
gasprod1-2;1206151;1691.141291;51.497411;6853;570;4845;5415;100
gasprod1-3;1206151;3682.336923;49.221179;8368;547;5902;6449;100
gasprod2-1;1206151;1306101.609201;404.201103;19;1768;15;1783;100
gasprod2-2;1206151;1330631.091637;502.800224;36;1704;28;1732;100
gen-ip002;1206151;-511.036897;0;3;0;0;0;89.32
gen-ip016;1206151;-9505.628173;1.906914;1;0;0;0;100
gen-ip021;1206151;6642.05262;2.217259;4;0;0;0;100
gen-ip036;1206151;-2162.833562;0;3;0;0;0;53.05
gen-ip054;1206151;16786.476526;1.032398;5;0;0;0;100
gen;1206151;112130.040664;7.929263;1;3;0;3;100
genus-g31-8;1206151;-27;112.333333;1;1499;2;1501;100
genus-g61-25;1206151;-58;262.979034;1;1304;2;1306;100
genus-sym-g31-8;1206151;-27;154.805251;2;4107;3;4110;100
genus-sym-g62-2;1206151;-54;255.080518;2;27652;3;27655;100
genus-sym-grafo5708-48;1206151;-27;115.165439;1;1532;0;1532;100
ger50-17-ptp-pop-3t;1206151;3466.324873;45.213645;1;125;0;125;100
ger50-17-ptp-pop-6t;1206151;6804.447088;50.477969;1;102;0;102;100
ger50-17-trans-dfn-3t;1206151;3453.475245;37.741927;1;190;1;191;100
ger50-17-trans-pop-3t;1206151;3456.252922;49.487013;1;178;1;179;100
ger50_17_trans;1206151;6850.628623;48.22611;1;165;1;166;100
germanrr;1206151;46445702.956442;53.468182;2;824;5;829;100
germany50-DBM;1206151;438028;23.4;1;163;0;163;100
germany50-UUM;1206151;597932.5;24.4;1;39;0;39;100
gesa2-o;1206151;25748173.191117;13.380406;2;5;0;5;100
gesa2;1206151;25477017.874283;13.26737;2;8;0;8;100
gfd-schedulen180f7d50m30k18-16i;1206151;18;108.385679;1;6773;96;6869;100
gfd-schedulen180f7d50m30k18;1206151;1;5019.413851;2;3782;22;3804;100
gfd-schedulen25f5d20m10k3i;1206151;3;13.619895;1;65;1;66;100
gfd-schedulen55f2d50m30k3i;1206151;3;27.695911;1;170;3;173;100
ghoulomb4-9-10i;1206151;9;0;1;65;1;66;0
glass-sc;1206151;29;0;3;119;1;120;26.09
glass4;1206151;800002400;2.059524;1;1;0;1;100
gmu-35-40;1206151;-2400283.756506;1.911023;2;10;0;10;100
gmu-35-50;1206151;-2606307.146543;3.420099;2;22;0;22;100
gmut-75-50;1206151;-14182312.661731;4.988967;1;813;9;822;100
gmut-76-40;1206151;-14171086.316075;9.054451;1;273;2;275;100
gmut-76-50;1206151;-14173884.188063;4.201959;1;555;6;561;100
gmut-77-40;1206151;-14173396.636852;2.97325;1;256;2;258;100
go19;1206151;95;0;3;5;0;5;13.1
gr4x6;1206151;229.05;0;2;0;0;0;13.19
graph20-20-1rand;1206151;-37;48;1;50;0;50;100
graph20-80-1rand;1206151;-117;142;1;1817;1;1818;100
graph40-20-1rand;1206151;-157;185.5;1;4956;3;4959;100
graph40-40-1rand;1206151;-300;341.96929;1;90397;17;90414;100
graphdraw-domain;1206151;12672;21.071817;1;2;0;2;100
graphdraw-gemcutter;1206151;4310;15.521554;1;1;0;1;100
graphdraw-grafo2;1206151;35762;368.152985;1;754;3;757;100
graphdraw-mainerd;1206151;30496;97.975651;1;81;0;81;100
graphdraw-opmanager;1206151;54717;207.745488;1;412;1;413;100
gsvm2rl11;1206151;35640.343493;0;3;342;0;342;96.67
gsvm2rl12;1206151;50;0;3;505;0;505;100
gsvm2rl3;1206151;0.6;0;3;3;0;3;78.29
gsvm2rl5;1206151;10;0;3;8;0;8;84.4
gsvm2rl9;1206151;16356.825869;0;3;62;0;62;100
gt2;1206151;13460.233074;0.728107;1;0;0;0;100
h50x2450;1206151;11147.731511;3.696751;1;26;0;26;100
h80x6320;1206151;3700;0;1;24;0;24;0
h80x6320d;1206151;5325.160104;2.515625;1;43;0;43;100
hanoi5;1206151;1926;332;4;162;1;163;100
haprp;1206151;3665963.213506;96.940858;1;4;0;4;100
harp2;1206151;-74353341.5023;5.485338;1;5;0;5;100
hgms-det;1206151;-53824.391476;32.676364;1;237;0;237;100
hgms30;1206151;-53349.215497;60.694272;1;8729;0;8729;100
hgms62;1206151;-53416.649907;61.317531;1;25819;0;25819;100
hypothyroid-k1;1206151;-2902.852586;39.591978;1;7116;2;7118;100
ic97_potential;1206151;4089;54.966667;2;3;0;3;100
ic97_tension;1206151;3911;15.366667;2;2;0;2;100
icir97_potential;1206151;6612;166.866667;2;38;0;38;100
icir97_tension;1206151;6302;97.366667;2;3;0;3;100
iis-100-0-cov;1206151;35;0;3;92;0;92;20.69
iis-bupa-cov;1206151;46;0;3;149;0;149;27.78
iis-glass-cov;1206151;26;0;3;114;1;115;23.81
iis-hc-cov;1206151;22;0;3;161;3;164;29.41
iis-pima-cov;1206151;39;0;3;203;1;204;18.18
irp;1206151;12123.530222;6;1;75;1;76;100
istanbul-no-cutoff;1206151;51.11;3.607411;1;414;0;414;100
ivu06-big;1206151;135.427718;95.799872;1;54745;179;54924;100
ivu06;1206151;135.901353;97.120377;1;15621;56;15677;100
ivu52;1206151;480.250439;81.742183;1;6900;15;6915;100
ivu59;1206151;884.456993;122.893682;1;104950;213;105163;100
janos-us-DDM;1206151;1488134.75;22.375;1;6;0;6;100
k16x240;1206151;11359;0;2;0;0;0;6.42
k16x240b;1206151;12874;0;2;0;0;0;13
k1mushroom;1206151;-4165.061224;43.877551;1;17329;7;17336;100
k1mushroomi;1206151;-4208;0;1;189;6;195;0
khb05250;1206151;126785464;0;2;1;0;1;18.56
l2p12;1206151;2;1091.539196;1;323;0;323;100
l2p1i;1206151;1;333.207461;1;780;13;793;100
l2p2i;1206151;1;616.41646;1;57;1;58;100
lectsched-1-obj;1206151;0;5.975758;2;227;5;232;100
lectsched-1;1206151;0;3.151515;2;201;6;207;100
lectsched-2;1206151;0;17.149242;5;123;8;131;100
lectsched-3;1206151;0;21.203788;6;216;14;230;100
lectsched-4-obj;1206151;0;12.853788;6;61;3;64;100
lectsched-5-obj;1206151;0;4.117424;2;194;4;198;100
leo1;1206151;1181219706.24;0;3;75;2;77;100
leo2;1206151;1344214233.44;0;3;180;4;184;100
liu;1206151;346;11.003653;2;5;0;5;100
loopha13;1206151;6.279;1.10216;2;206;1;207;100
lotsize;1206151;1335747.052789;7.405615;2;5;0;5;100
lr1dr02vc05v8a-t360;1206151;120706.326475;174.298112;1;847;1;848;100
lr1dr04vc05v17a-t360;1206151;247111.69248;335.090553;1;1924;1;1925;100
lr1dr12vc10v70b-t360;1206151;983950.247945;1069.593454;1;44806;10;44816;100
lr2-22dr3-333vc4v17a-t60;1206151;-72838.215835;239.748662;2;38102;13;38115;100
lrn;1206151;42701141.648089;65.099086;2;441;0;441;100
m100n500k4r1;1206151;-18;0;3;6;0;6;28
macrophage;1206151;0;339;1;29;0;29;100
mad;1206151;0;3.254396;1;1;0;1;100
manna81;1206151;-10107;0;3;35;0;35;23.22
map06;1206151;-406.181173;7.868443;1;2393;1;2394;100
map10;1206151;-602.176181;11.248146;1;2629;1;2630;100
map14;1206151;-778.549324;11.962355;1;2170;1;2171;100
map14860-20;1206151;-998.836419;10.400693;1;2493;1;2494;100
map16715-04;1206151;-296.267898;4.997036;1;2279;1;2280;100
map18;1206151;-932.782685;11.173489;1;2263;1;2264;100
map20;1206151;-998.836419;10.400693;1;2503;1;2504;100
mappingmesh3x3mpeg2i;1206151;87.555556;87.202393;1;34;0;34;100
mario-t-hard5i;1206151;-4482;20.339623;1;1368;2;1370;100
markshare1;1206151;230;0;2;0;0;0;100
markshare2;1206151;454;0;2;0;0;0;100
markshare_4_0;1206151;226;0;2;0;0;0;100
markshare_5_0;1206151;337;0;2;0;0;0;100
mas74;1206151;10482.79528;3.103514;1;1;0;1;100
mas76;1206151;38893.903641;2.555097;1;1;0;1;100
maxgasflow;1206151;-70929535.9;662.35764;2;54;0;54;100
mc11;1206151;13509;0;2;28;0;28;15.57
mc7;1206151;5796;0;2;29;0;29;69.62
mc8;1206151;1929;0;2;28;0;28;23.18
mcsched;1206151;193774.753707;340.221655;1;141;0;141;100
methanosarcina;1206151;0;313;1;107;0;107;100
mik-250-1-100-1;1206151;0;0;2;2;0;2;100
mik-250-20-75-1;1206151;0;0;2;3;0;3;100
mik-250-20-75-2;1206151;0;0;2;3;0;3;100
mik-250-20-75-3;1206151;0;0;2;3;0;3;100
mik-250-20-75-4;1206151;0;0;2;3;0;3;100
mik-250-20-75-5;1206151;0;0;2;3;0;3;100
milo-v12-6-r1-58-1;1206151;410986.648167;129.9058;1;95;0;95;100
milo-v12-6-r1-75-1;1206151;669700.757896;208.836475;1;104;0;104;100
milo-v12-6-r2-40-1;1206151;205532.322265;97.329375;1;65;0;65;100
milo-v13-4-3d-3-0;1206151;23359.288017;1.476277;1;14;0;14;100
milo-v13-4-3d-4-0;1206151;34031.171805;2.550972;1;25;0;25;100
mine-166-5;1206151;-821763677.673139;187.331384;1;214;0;214;100
mine-90-10;1206151;-887165318.510226;202.375368;1;158;0;158;100
mining;1206151;-885353915.925571;8477.535071;96;122270;2679;124949;100
minutedispatchstrategy;1206151;1898.391429;412.137934;2;1312;2;1314;100
misc07;1206151;1415;8;1;3;0;3;100
mitre;1206151;114740.518481;224.156743;1;97;0;97;100
mkc;1206151;-581.85;16.208843;3;29;0;29;100
mkc1;1206151;-611.85;3.942199;3;30;0;30;100
mod010;1206151;6532.083333;14.166667;1;14;0;14;100
modglob;1206151;20786787.016883;0;2;2;0;2;0.22
moj-mining;1206151;-1520532907.35018;566.626558;2;45774;0;45774;100
momentum1;1206151;134660.011921;48.045264;2;1101;1;1102;100
momentum2;1206151;61266.821316;84.616225;3;713;2;715;100
momentum3;1206151;107721.82427;144.721031;3;8519;1;8520;100
mrcpspj30-15-5i;1206151;23;189.992887;1;40;0;40;100
mrcpspj30-17-10i;1206151;25;28.677778;1;38;0;38;100
mrcpspj30-53-3i;1206151;30;43.135185;1;38;0;38;100
msc98-ip;1206151;19520966.151663;393.288169;2;2782;2;2784;100
mspp16;1206151;341;1.241379;1;26656;141;26797;100
mspsphard01i;1206151;16;0;1;45;0;45;0
mspsphard03i;1206151;20;0;1;84;1;85;0
mtest4ma;1206151;60342;0;2;2;0;2;15.71
mushroom-best;1206151;1.3e-05;0.0202;1;562;1;563;100
mzzv11;1206151;-22556.460829;174.328454;2;426;1;427;100
mzzv42z;1206151;-18842.814586;198.473995;2;285;1;286;100
n13-3;1206151;14401970;0;2;29;0;29;100
n15-3;1206151;71710891;0;2;3264;0;3264;0
n2seq36f;1206151;70600;0;3;34;1;35;35.25
n2seq36q;1206151;116003.593822;43.392098;3;159;4;163;100
n3-3;1206151;24303430;0;2;166;0;166;100
n3700;1206151;1342560;0;2;27;0;27;9.36
n3705;1206151;1342540;0;2;30;0;30;9.55
n3707;1206151;1301218;0;2;28;0;28;9.65
n3709;1206151;1324904;0;2;28;0;28;9.68
n370a;1206151;1353042;0;2;27;0;27;0
n370b;1206151;1373791;0;2;29;0;29;11.06
n3div36;1206151;201600;0;3;143;6;149;54.13
n3seq24;1206151;189033.068485;51.670786;3;3032;62;3094;100
n4-3;1206151;13501875;0;2;49;0;49;100
n5-3;1206151;12301325;0;2;13;0;13;100
n6-3;1206151;16502900;0;2;38;0;38;100
n7-3;1206151;14704310;0;2;40;0;40;100
n9-3;1206151;20703625;0;2;137;0;137;100
nag;1206151;465;13.770256;3;47;0;47;100
neos-1061020;1206151;-145860.370608;500.756757;1;893;0;893;100
neos-1067731;1206151;669053;81.272727;1;583;0;583;100
neos-1109824;1206151;278;22;1;58;0;58;100
neos-1112782;1206151;22000000110147.3;0;2;27;0;27;100
neos-1112787;1206151;19500000125389.7;0;2;25;0;25;100
neos-1122047;1206151;161;0.495966;2;474;0;474;100
neos-1171448;1206151;-309;0.936995;2;80;0;80;100
neos-1171692;1206151;-273;3.730892;2;41;0;41;100
neos-1171737;1206151;-195;8.004699;2;42;0;42;100
neos-1225589;1206151;5e+09;0;2;1;0;1;100
neos-1311124;1206151;-182;5;2;4;0;4;100
neos-1324574;1206151;4.5;144;1;37;0;37;100
neos-1330346;1206151;4.5;76.5;1;105;0;105;100
neos-1337307;1206151;-201272;272.493985;2;50;0;50;100
neos-1354092;1206151;46;238.398385;2;1069;2;1071;100
neos-1367061;1206151;31320456.264497;3.75;2;1899;1;1900;100
neos-1396125;1206151;3000.053717;12.531496;2;8;0;8;100
neos-1420546;1206151;22124.4;103.140678;1;380;0;380;100
neos-1420790;1206151;2942.750002;75.132359;1;46;0;46;100
neos-1423785;1206151;-1816.666667;311.9714;1;237;0;237;100
neos-1425699;1206151;3175204364.6353;5.264952;1;0;0;0;100
neos-1426635;1206151;-178;6.429182;2;2;0;2;100
neos-1426662;1206151;-52;10.501303;2;4;0;4;100
neos-1429212;1206151;30;713.975748;1;5336;14;5350;100
neos-1430701;1206151;-78;6.669599;2;4;0;4;100
neos-1436709;1206151;-129;3.502607;2;4;0;4;100
neos-1440225;1206151;36;33.503789;1;113;0;113;100
neos-1440460;1206151;-180;4.85975;2;2;0;2;100
neos-1442119;1206151;-182;2.580471;2;4;0;4;100
neos-1442657;1206151;-156;4.002933;2;3;0;3;100
neos-1445532;1206151;-22877;8.21746;2;87;0;87;100
neos-1445738;1206151;-24232.548846;16.301135;1;160;0;160;100
neos-1445743;1206151;-24579.832968;16.920281;1;159;0;159;100
neos-1445765;1206151;-24699.19766;17.625849;1;152;0;152;100
neos-1456979;1206151;154;8.434222;1;43;0;43;100
neos-1516309;1206151;34769.833333;9.166667;2;31;0;31;100
neos-1582420;1206151;88.398466;56.693409;5;79;1;80;100
neos-1593097;1206151;4424;55.795872;1;109;1;110;100
neos-1599274;1206151;32194.742857;6.464286;3;38;1;39;100
neos-1601936;1206151;1;155.387702;1;783;0;783;100
neos-1603965;1206151;619244367.662955;0.000913;1;605;0;605;100
neos-1605061;1206151;6.150735;159.498166;1;2476;0;2476;100
neos-1605075;1206151;3.214461;176.495942;1;1938;0;1938;100
neos-1616732;1206151;173;0;3;5;0;5;8.81
neos-1620770;1206151;22;35;2;38;0;38;100
neos-2294525-abba;1206151;156.177251;16.071056;1;80;0;80;100
neos-2328163-agri;1206151;26069;54.9;1;64;0;64;100
neos-2624317-amur;1206151;0;33.918936;1;2;0;2;100
neos-2629914-sudost;1206151;39622;7.942933;1;198;0;198;100
neos-2652786-brda;1206151;0;19.477348;2;1;0;1;100
neos-2657525-crna;1206151;0;28.234944;2;1;0;1;100
neos-2669500-cust;1206151;2221.9;230.19862;2;920;12;932;100
neos-2746589-doon;1206151;1985.75;129.965898;2;282;5;287;100
neos-2974461-ibar;1206151;473452396.770997;3364;2;201611;31;201642;100
neos-2978193-inde;1206151;-2.418518;7.4;1;61;0;61;100
neos-2978205-isar;1206151;-12.415307;29.8;1;197;0;197;100
neos-2987202-jeir;1206151;-1847551552.23661;1035.632796;2;63996;1;63997;100
neos-2987310-joes;1206151;-610797465.676974;19.875;2;1808;0;1808;100
neos-2991472-kalu;1206151;459.673619;4.82467;13792;4327;753205;757532;100
neos-3004026-krka;1206151;0;832;1;58;0;58;100
neos-3009394-lami;1206151;0.642857;216.114286;2;4;0;4;100
neos-3024952-loue;1206151;22882;103.3;1;232;0;232;100
neos-3025225-shelon;1206151;0.052574;323.690533;1;98238;41;98279;100
neos-3046601-motu;1206151;185;0.4492;1;1;0;1;100
neos-3046615-murg;1206151;192;0.3458;1;0;0;0;100
neos-3048764-nadi;1206151;-3883988306.36669;0;2;66;0;66;0
neos-3065804-namu;1206151;0;0;1;188;0;188;0
neos-3068746-nene;1206151;77427529.530929;55.412658;2;138;0;138;100
neos-3072252-nete;1206151;10593526;1.938794;2;1;0;1;100
neos-3075395-nile;1206151;54.924462;0.00048;1;170;0;170;100
neos-3083784-nive;1206151;0;12;1;24;0;24;100
neos-3083819-nubu;1206151;6290575.552807;13.541087;1;46;0;46;100
neos-3116779-oban;1206151;0;0;1;23;0;23;0
neos-3118745-obra;1206151;357;0;2;5;0;5;40
neos-3148108-pahi;1206151;0;0;1;272;1;273;0
neos-3209462-rhin;1206151;0;49.45122;2;3670;1;3671;100
neos-3209519-ruhr;1206151;332.85;25.900482;1;60;0;60;100
neos-3214367-sovi;1206151;87802.732596;99.258257;1;2161;0;2161;100
neos-3216931-puriri;1206151;58817.353066;51.622705;1;977;0;977;100
neos-3226448-wkra;1206151;0;512.043709;1;816;0;816;100
neos-3237086-abava;1206151;0;96;1;254;2;256;100
neos-3322547-alsek;1206151;616;115.178534;2;10182;67;10249;100
neos-3352863-ancoa;1206151;495300;0;2;648;8;656;100
neos-3354841-apure;1206151;48447.926267;3.552995;1;2747;23;2770;100
neos-3355120-tarago;1206151;-20453473.616781;80.899969;1;599;1;600;100
neos-3355323-arnon;1206151;0;21.818182;4;74;3;77;100
neos-3372571-onahau;1206151;0.57699;8.695953;2;1404;0;1404;100
neos-3373491-avoca;1206151;21687686014.0154;26.555947;1;6;0;6;100
neos-3381206-awhea;1206151;432;61.334767;2;5;0;5;100
neos-3402294-bobin;1206151;0;35.009213;1;1017;10;1027;100
neos-3426085-ticino;1206151;235;41.78747;3;28;0;28;100
neos-3426132-dieze;1206151;427;103.670666;2;69;0;69;100
neos-3437289-erdre;1206151;0;0;1;84;0;84;0
neos-3530903-gauja;1206151;170;33.253136;3;4;0;4;100
neos-3530905-gaula;1206151;153;29.042208;2;4;0;4;100
neos-3555904-turama;1206151;-41.45;29.464286;1;818;4;822;100
neos-3572885-glina;1206151;0;0;1;423;2;425;0
neos-3581454-haast;1206151;1640;52;1;99;0;99;100
neos-3592146-hawea;1206151;7237144.855333;13.694653;1;45;0;45;100
neos-3594536-henty;1206151;383205;2496;1;151;1;152;100
neos-3603137-hoteo;1206151;0;34.208333;3;44;1;45;100
neos-3610040-iskar;1206151;45;0;2;2;0;2;21.62
neos-3610051-istra;1206151;64;0;2;9;0;9;30.61
neos-3610173-itata;1206151;180;0;2;6;0;6;21.62
neos-3611447-jijia;1206151;129;0;2;3;0;3;20.56
neos-3611689-kaihu;1206151;151;0;2;3;0;3;26.89
neos-3615091-sutlej;1206151;-1506391.117177;170;1;1638;9;1647;100
neos-3627168-kasai;1206151;1020229.4;0;2;3;0;3;3.2
neos-3634244-kauru;1206151;0;152.72;1;4271;7;4278;100
neos-3636886-kereu;1206151;4092.95754;2e-05;2;62;1;63;100
neos-3656078-kumeu;1206151;-18774.7;144.152983;2;211;1;212;100
neos-3660371-kurow;1206151;286.534383;18.305351;1;37;0;37;100
neos-3661949-lesse;1206151;688975700;0.00026;2;52;0;52;100
neos-3665875-lesum;1206151;248.325;39.496094;4;68;0;68;100
neos-3682128-sandon;1206151;79915933.274829;141.641588;2;271;0;271;100
neos-3691541-lonja;1206151;-0.079271;1.110009;2;43;0;43;100
neos-3695882-vesdre;1206151;-145935.214286;38.62531;1;499;3;502;100
neos-3696678-lyvia;1206151;4.90689;306.477181;2;47;0;47;100
neos-3699377-maori;1206151;135877.224265;88.272067;2;106;0;106;100
neos-3703351-marne;1206151;317056.210386;66.75637;2;54;0;54;100
neos-3740487-motru;1206151;152.145486;83.106404;2;40675;72;40747;100
neos-3754480-nidda;1206151;-1216923.270104;12.186832;1;3;0;3;100
neos-3755335-nizao;1206151;50.030157;72.893283;2;532;1;533;100
neos-3759587-noosa;1206151;48.334468;3.376667;2;328;1;329;100
neos-3761878-oglio;1206151;422769.022545;76.021852;2;44;0;44;100
neos-3762025-ognon;1206151;603955.746492;55.414542;2;38;0;38;100
neos-4165869-wannon;1206151;282.410166;67.168679;3;584;5;589;100
neos-4230265-orari;1206151;10055874880.8713;2982.245145;241;4364;176;4540;100
neos-4260495-otere;1206151;3336.109119;251.27169;2;762;15;777;100
neos-4285819-pedja;1206151;9.198014;17.924816;2;122971;91;123062;100
neos-4290317-perth;1206151;6352398.05574;0;2;614;1;615;100
neos-4292145-piako;1206151;203075008.660562;3215.980526;241;3529;175;3704;100
neos-4295773-pissa;1206151;0;3220.505376;1;5152;5;5157;100
neos-4300652-rahue;1206151;0;49;2;737;2;739;100
neos-4306827-ravan;1206151;-35696.901913;2144.305389;5;766;31;797;100
neos-4321076-ruwer;1206151;1880.558333;39.333333;1;15538;1;15539;100
neos-4322846-ryton;1206151;0.419848;26;1;555;5;560;100
neos-4332801-seret;1206151;222328.384492;6070.103294;3;111197;2754;113951;100
neos-4332810-sesia;1206151;-33931.341204;4092.28388;13;104799;9638;114437;100
neos-4333464-siret;1206151;24.731464;0.125;2;76;1;77;100
neos-4333596-skien;1206151;-14653956.91493;0.180763;1;19;0;19;100
neos-4335793-snake;1206151;0;300.868689;2;1114;2;1116;100
neos-4338804-snowy;1206151;1447;0.33;3;5;0;5;100
neos-4343293-stony;1206151;51.62736;0.5;2;83;0;83;100
neos-4355351-swalm;1206151;33.822611;0.094819;2;172;3;175;100
neos-4358725-tagus;1206151;6199.400001;198.323744;73;579;15;594;100
neos-4359986-taipa;1206151;0.296593;39.062139;1;1122;1;1123;100
neos-4360552-sangro;1206151;-29.5;557.645354;1;12882;1;12883;100
neos-4387871-tavua;1206151;36.445048;0.2;2;44;0;44;100
neos-4391920-timok;1206151;9e-06;37.747142;1;6923;4;6927;100
neos-4393408-tinui;1206151;340.267489;0.2;2;35;0;35;100
neos-4408804-prosna;1206151;914.483516;66.321429;1;2751;2;2753;100
neos-4409277-trave;1206151;0;347.723278;1;2032;1;2033;100
neos-4413714-turia;1206151;43.474651;371.333441;1;1910;11;1921;100
neos-4532248-waihi;1206151;0;26.333333;1;734;4;738;100
neos-4533806-waima;1206151;3063.318841;99;1;1111;9;1120;100
neos-4545615-waita;1206151;3606.59419;108.263827;1;15439;71;15510;100
neos-4555749-wards;1206151;3026.812121;68.666667;1;812;9;821;100
neos-4562542-watut;1206151;3743.304348;85.428571;1;3245;14;3259;100
neos-4647027-thurso;1206151;26911.641616;127.083433;1;2518;0;2518;100
neos-4647030-tutaki;1206151;26911.641616;130.175014;1;2758;0;2758;100
neos-4647032-veleka;1206151;26587.908699;174.815461;1;3891;0;3891;100
neos-4650160-yukon;1206151;-22688.54768;228.864;1;5;0;5;100
neos-4722843-widden;1206151;1841.255082;1452.768981;2;409;5;414;100
neos-4724674-aorere;1206151;3758.753179;59.078997;3;517;11;528;100
neos-4736745-arroux;1206151;653873224.676537;1.560199;2;41;0;41;100
neos-4738912-atrato;1206151;617323325.173629;52.400465;2;47;0;47;100
neos-4754521-awarau;1206151;0;0;1;1182;6;1188;0
neos-4760493-puerua;1206151;1908.243695;237.071976;1;33120;3;33123;100
neos-476283;1206151;406.244708;4.622056;2;4296;0;4296;100
neos-4763324-toguru;1206151;1120.986062;232.945926;1;33069;3;33072;100
neos-4797081-pakoka;1206151;0;827.858104;1;5811;2;5813;100
neos-4805882-barwon;1206151;1676.929283;206.756435;2;246;2;248;100
neos-480878;1206151;515.138796;1.008444;2;18;0;18;100
neos-4954274-beardy;1206151;18659.208282;301.285291;2;963;2;965;100
neos-4954672-berkel;1206151;3733961;4.007059;2;3;0;3;100
neos-4966258-blicks;1206151;354.545455;450.828848;3;1467;4;1471;100
neos-4971100-bodrog;1206151;0;0;2;78;0;78;100
neos-4972437-bojana;1206151;355.557128;31.979415;2;8458;4;8462;100
neos-4972461-bolong;1206151;465.045599;50.250248;2;4753;3;4756;100
neos-4976951-bunnoo;1206151;375.694372;25.259996;2;6841;4;6845;100
neos-4984115-canche;1206151;-10414620.716097;6.967648;1;17962;0;17962;100
neos-498623;1206151;16;44.05751;1;122;0;122;100
neos-5013590-toitoi;1206151;1064.447092;169;1;12639;1;12640;100
neos-5018451-chiese;1206151;-149772385.216405;18.530618;1;63414;1;63415;100
neos-503737;1206151;50;47.555718;1;29;0;29;100
neos-5041822-cockle;1206151;5696053.417116;2.418448;3;2529;26;2555;100
neos-5044663-wairoa;1206151;4653100;541.481293;1;21958;1;21959;100
neos-5045105-creuse;1206151;19.06667;21.458183;1;83;0;83;100
neos-5049753-cuanza;1206151;464;69.6;3;2458;5;2463;100
neos-5051588-culgoa;1206151;128.75;31.449091;1;107;0;107;100
neos-5052403-cygnet;1206151;220.147435;87.133886;8;36623;177;36800;100
neos-506422;1206151;0;6.9;1;46;0;46;100
neos-506428;1206151;145945;95.648936;1;595;3;598;100
neos-5075914-elvire;1206151;277.341888;3.120913;2;49;0;49;100
neos-5076235-embley;1206151;1930;0.115385;2;912;0;912;100
neos-5078479-escaut;1206151;7280.474567;0.467977;2;51;0;51;100
neos-5079731-flyers;1206151;2004;1.087912;2;913;0;913;100
neos-5083528-gimone;1206151;0;20.875;1;279;4;283;100
neos-5093327-huahum;1206151;3934;1.841667;2;881;0;881;100
neos-5100895-inster;1206151;2084;3.582418;2;530;0;530;100
neos-5102383-irwell;1206151;1740;2.483516;2;883;0;883;100
neos-5104907-jarama;1206151;639.917149;50.953837;2;9225;4;9229;100
neos-5106984-jizera;1206151;721;3.5;2;3630;7;3637;100
neos-5107597-kakapo;1206151;0;0.59125;2;42;0;42;100
neos-5108386-kalang;1206151;620.501637;57.690941;2;13141;11;13152;100
neos-5114902-kasavu;1206151;518;138;3;9503;16;9519;100
neos-5115478-kaveri;1206151;0;0.529375;2;42;0;42;100
neos-5116085-kenana;1206151;452;142;3;5445;10;5455;100
neos-5118834-korana;1206151;569.216333;123.504863;2;12381;7;12388;100
neos-5118851-kowhai;1206151;1134;5.88;2;5379;9;5388;100
neos-5123665-limmat;1206151;652.42743;71.017903;2;16828;9;16837;100
neos-5125849-lopori;1206151;0;51.956886;1;42;0;42;100
neos-5129192-manaia;1206151;0;3.769231;1;4066;11;4077;100
neos-5138690-middle;1206151;605.364996;106.306535;2;14713;18;14731;100
neos-5140963-mincio;1206151;8877;2.142857;1;1;0;1;100
neos-5149806-wieprz;1206151;0.027694;5.514108;5;395;14;409;100
neos-5151569-mologa;1206151;686023627.750363;27.702234;2;2113;2;2115;100
neos-5178119-nalagi;1206151;8.569859;18.661577;2;64;1;65;100
neos-5182409-nasivi;1206151;0;18.212177;1;7;0;7;100
neos-5188808-nattai;1206151;0;13.024442;1;361;0;361;100
neos-5189128-totara;1206151;330131.390743;21.863581;1;944;2;946;100
neos-5192052-neckar;1206151;-11980000;0.333333;3;0;0;0;100
neos-5193246-nerang;1206151;0;792.331614;1;835;1;836;100
neos-5195221-niemur;1206151;0;700.447361;1;748;1;749;100
neos-5196530-nuhaka;1206151;0;750.534707;1;582;1;583;100
neos-520729;1206151;-1391291.666667;8.76;1;555;1;556;100
neos-5221106-oparau;1206151;0;61.698592;1;268;1;269;100
neos-5223573-tarwin;1206151;0.1058;0.258185;1;15166;3;15169;100
neos-5251015-ogosta;1206151;0.1058;0.226665;1;12467;2;12469;100
neos-525149;1206151;60;3.5;1;273;5;278;100
neos-5260764-orauea;1206151;58748.022532;10.633838;1;65;0;65;100
neos-5261882-treska;1206151;22721.328;6.436135;1;14;0;14;100
neos-5266653-tugela;1206151;20969.906674;15.508215;1;135;1;136;100
neos-5273874-yomtsa;1206151;0;0.2152;1;14656;2;14658;100
neos-555001;1206151;910619.201473;185.329242;1;40;0;40;100
neos-555343;1206151;1241512.54944;273.503416;1;37;0;37;100
neos-555424;1206151;1196312.54944;237.883186;1;33;0;33;100
neos-555884;1206151;1026121.836055;271.3209;1;40;0;40;100
neos-565672;1206151;43884.639336;66.477422;3;15117;17;15134;100
neos-574665;1206151;4948073.456141;10.746401;1;43;0;43;100
neos-578379;1206151;0;134.758643;1;1151;1;1152;100
neos-585192;1206151;-1999690.155301;98.986683;2;187;0;187;100
neos-585467;1206151;-1999711.795869;82.239088;2;22;0;22;100
neos-595904;1206151;61134.474995;16.114622;2;66;0;66;100
neos-619167;1206151;1.481241;34.850492;1;99;0;99;100
neos-631517;1206151;6494999.999936;60.866544;1;8;0;8;100
neos-631710;1206151;544;293.45197;2;6292;16;6308;100
neos-633273;1206151;4678552871.15256;377.739286;1;187;0;187;100
neos-662469;1206151;184340.629649;96.375734;1;433;1;434;100
neos-686190;1206151;5134.81383;17.515957;1;109;0;109;100
neos-691058;1206151;234;83.065598;1;201;0;201;100
neos-693347;1206151;234;75.573465;1;648;0;648;100
neos-738098;1206151;-1099;225.695149;1;120;0;120;100
neos-777800;1206151;-80;68.220262;1;44;0;44;100
neos-780889;1206151;3421500;0;1;625;8;633;0
neos-787933;1206151;300;0;2;233;18;251;100
neos-799711;1206151;-11228065.153797;0.981255;1;1196;0;1196;100
neos-799716;1206151;4932670.661692;0.616814;1;118;0;118;100
neos-807639;1206151;492.688889;1.37037;2;10;0;10;100
neos-820879;1206151;24874.267857;62.867619;1;113;0;113;100
neos-824661;1206151;51;60.642857;2;246;3;249;100
neos-824695;1206151;42;33.8;3;95;1;96;100
neos-826224;1206151;130;70;3;203;3;206;100
neos-826650;1206151;32;109.347222;2;42;0;42;100
neos-826694;1206151;73;92.333333;3;90;2;92;100
neos-826812;1206151;70.011;151.137255;3;103;1;104;100
neos-826841;1206151;32.0082;110.679849;2;41;0;41;100
neos-827015;1206151;2.098071;332.649497;1;1903;3;1906;100
neos-827175;1206151;116.00152;83.555556;2;164;1;165;100
neos-829552;1206151;2.098071;250.649497;1;1680;2;1682;100
neos-831188;1206151;1.76772;215.733333;1;80;0;80;100
neos-847302;1206151;0;49.875712;1;75;0;75;100
neos-848198;1206151;168781;0;2;162;0;162;100
neos-848589;1206151;0;0.075873;1;1425;1;1426;100
neos-849702;1206151;0;87.382423;1;20;0;20;100
neos-850681;1206151;2087;60.770833;1;107;0;107;100
neos-860300;1206151;1666.068586;9;1;57;1;58;100
neos-872648;1206151;52.672838;0;2;1357;8;1365;8.36
neos-873061;1206151;152.431558;0;2;1202;8;1210;34.12
neos-876808;1206151;10030.533833;259.649605;2;6408;10;6418;100
neos-885086;1206151;-243;13.945733;2;164;0;164;100
neos-885524;1206151;11771.55529;9.581376;2;190;7;197;100
neos-911880;1206151;23.26;17.986476;1;2;0;2;100
neos-911970;1206151;23.26;14.456206;1;2;0;2;100
neos-913984;1206151;1000;33.522949;1;156;3;159;100
neos-914441;1206151;5660364.28377;78.177859;1;1705;0;1705;100
neos-916792;1206151;26.203596;16.256328;2;81;0;81;100
neos-932721;1206151;513000;0;4;103;4;107;100
neos-932816;1206151;513000;0;3;208;8;216;100
neos-933562;1206151;0;237.810567;1;56;0;56;100
neos-933638;1206151;335654.662576;0;3;211;5;216;100
neos-933966;1206151;338609.316425;0;3;158;5;163;100
neos-934278;1206151;341538.344697;0;3;295;3;298;100
neos-935234;1206151;368364.764662;0;3;334;1;335;100
neos-935627;1206151;19212.297957;0;3;368;1;369;100
neos-935769;1206151;20474.736468;0;3;414;1;415;100
neos-937511;1206151;46568.6957;0;3;419;1;420;100
neos-937815;1206151;44927.403873;0;3;493;1;494;100
neos-941262;1206151;43855.974502;0;3;361;1;362;100
neos-941313;1206151;9361;325.995652;1;601;8;609;100
neos-942830;1206151;12;68.941632;1;33;0;33;100
neos-948126;1206151;46136.445498;0;3;406;1;407;100
neos-948346;1206151;-212.198292;3.766956;6;500;24;524;100
neos-950242;1206151;2;94;2;111;1;112;100
neos-953928;1206151;-97.806667;0;4;224;6;230;2.1
neos-954925;1206151;-229.766667;0;5;1077;31;1108;3.37
neos-956971;1206151;-235.74;1.742917;4;779;15;794;100
neos-957143;1206151;-204.669492;48.100823;4;481;16;497;100
neos-957323;1206151;-207.803654;25.352843;3;332;11;343;100
neos-957389;1206151;1.5;30.754586;1;103;1;104;100
neos-960392;1206151;-238;303.359003;1;256;2;258;100
neos-983171;1206151;48239.726119;0;3;413;1;414;100
neos-984165;1206151;43929.5052;0;3;466;1;467;100
neos13;1206151;-126.178378;42.160092;2;218;0;218;100
neos15;1206151;144796.909577;0;2;1;0;1;79.65
neos16;1206151;429;13.142857;2;3;0;3;100
neos17;1206151;0.222688;0;2;6;0;6;48.46
neos18;1206151;11;59;3;91;1;92;100
neos2;1206151;-4717.666848;6.724359;1;7;0;7;100
neos22;1206151;413700;227;1;30;0;30;100
neos5;1206151;17.25;0;3;1;0;1;15
neos6;1206151;116.604289;27.902196;4;99;6;105;100
neos8;1206151;-2885.143864;22.041691;3;752;6;758;100
neos808444;1206151;0;221.165702;1;218;1;219;100
neos9;1206151;780;44.25;1;286;0;286;100
net12;1206151;47.514236;132.660069;3;1156;1;1157;100
netdiversion;1206151;454.4;774.4;3;9060;16;9076;100
newdano;1206151;11.724138;8.447296;1;3;0;3;100
nexp-150-20-1-5;1206151;84;0;2;39;0;39;27.27
nexp-150-20-8-5;1206151;656;0;2;82;1;83;100
nexp-50-20-1-1;1206151;34;0;2;1;0;1;17.24
nexp-50-20-4-2;1206151;120;0;2;2;0;2;69.01
nh97_potential;1206151;1461;72.75;2;5;0;5;100
nh97_tension;1206151;1438;81.583333;2;2;0;2;100
nj1;1206151;0;607;1;514;1;515;100
nj2;1206151;0;607;1;682;1;683;100
nj3;1206151;0;607;1;66267;1;66268;100
nobel-eu-DBE;1206151;7662120;0;2;91;0;91;100
noswot;1206151;-9;0;2;1;0;1;78.05
ns1111636;1206151;96.25;19.25;1;623;2;625;100
ns1116954;1206151;0;144.400486;1;794;1;795;100
ns1208400;1206151;0;89.16614;1;61;0;61;100
ns1430538;1206151;73.621609;10.155449;1;549;0;549;100
ns1456591;1206151;361.939022;19;1;117;1;118;100
ns1606230;1206151;13.225;182.603065;1;1809;0;1809;100
ns1631475;1206151;817.193748;716.662243;1;1270;1;1271;100
ns1663818;1206151;1;9.141146;1;5972;84;6056;100
ns1679495;1206151;3337055.001914;100.246101;2;49505;12;49517;100
ns1685374;1206151;-51.800913;96.218654;1;50627;1;50628;100
ns1688347;1206151;2;5.051506;1;54;0;54;100
ns1690781;1206151;-1022.785697;17.664172;2;192;1;193;100
ns1696083;1206151;2;13.475541;1;129;1;130;100
ns1758913;1206151;-1501.183256;124.830251;1;7186;7;7193;100
ns1760995;1206151;-1379.173237;142;1;21008;8;21016;100
ns1778858;1206151;-22635740;227.465047;2;301;0;301;100
ns1828997;1206151;0;75;2;871;3;874;100
ns1830653;1206151;6153;57.880312;1;127;0;127;100
ns1849932;1206151;546;6.131653;1;1062;6;1068;100
ns1853823;1206151;1172000;1386;2;51836;23;51859;100
ns1854840;1206151;1.432e+11;1139.47326;2;6920;17;6937;100
ns1856153;1206151;0;254.167528;1;150;0;150;100
ns1904248;1206151;0;854.146124;14;2614;35;2649;100
ns1905797;1206151;11.75098;19.65;1;196;1;197;100
ns1905800;1206151;6.4366;16.364665;1;41;0;41;100
ns1952667;1206151;0;10.112982;1;213;1;214;100
ns2017839;1206151;77026281754033.4;1.017799;2;7784;0;7784;100
ns2034125;1206151;0;796.623735;2;1890;1;1891;100
ns2071214;1206151;0;60.238929;1;81;0;81;100
ns2081729;1206151;4.6;0.852;2;3;0;3;100
ns2122698;1206151;62785.622771;194.641858;1;551;1;552;100
ns2124243;1206151;53998.333333;195.416667;1;462;1;463;100
ns2137859;1206151;24629;42.075016;1;764;5;769;100
ns4-pr3;1206151;36073;12;1;100;0;100;100
ns4-pr6;1206151;29145.75;8.875;1;50;0;50;100
ns4-pr9;1206151;35175;10;1;93;0;93;100
ns894236;1206151;18;199.238568;2;394;0;394;100
ns894244;1206151;16;340.564115;2;1202;1;1203;100
ns894786;1206151;14;210.712983;2;1355;2;1357;100
ns894788;1206151;7;91.946694;2;173;0;173;100
ns903616;1206151;22;385.201946;2;1043;2;1045;100
nsa;1206151;91.44794;7.482504;1;7;0;7;100
nsr8k;1206151;17500809.511815;639.929911;1;9036;3;9039;100
nsrand-ipx;1206151;646400;0;2;67;2;69;100
nu120-pr12;1206151;38070;13.695833;1;47;0;47;100
nu120-pr3;1206151;21306.442308;42.751022;1;114;0;114;100
nu120-pr9;1206151;19062.5;28.652083;1;87;0;87;100
nu25-pr12;1206151;52757.5;11.9;1;62;0;62;100
nu4-pr9;1206151;35175;22.513333;1;92;0;92;100
nu60-pr9;1206151;22850;28.383333;1;89;0;89;100
nucorsav;1206151;29.0461;81.032136;2;81855;273;82128;100
nursesched-medium-hint03;1206151;33.468485;460.316255;1;1175;3;1178;100
nursesched-medium04;1206151;411;279.979978;2;776;7;783;100
nursesched-sprint-hidden09;1206151;580.911765;177.875;2;428;2;430;100
nursesched-sprint-late03;1206151;34.254806;178.177416;1;406;2;408;100
nursesched-sprint02;1206151;129.416667;125.4375;2;257;2;259;100
nw04;1206151;16310.666667;2;1;285;6;291;100
ofi;1206151;6131846109.62063;1781.999298;135;10040;145;10185;100
ofi2;1206151;6124829152.73116;3158.688481;133;7163;209;7372;100
oocsp-racks030e6cci;1206151;0;0;1;213;2;215;0
opm2-z10-s2;1206151;-18466;0;6;22933;15;22948;45.41
opm2-z10-s4;1206151;-16036;0;5;22787;13;22800;51.8
opm2-z11-s8;1206151;-22036;0;5;50070;18;50088;49.33
opm2-z12-s14;1206151;-35782;0;6;117700;27;117727;44.34
opm2-z12-s7;1206151;-36893;0;6;108890;28;108918;43.69
opm2-z12-s8;1206151;-31528;0;6;108433;26;108459;46.14
opm2-z6-s1;1206151;-3261;0;4;310;1;311;47.42
opm2-z7-s2;1206151;-6001;0;5;866;3;869;41.62
opm2-z7-s8;1206151;-6402;0;5;752;3;755;43.05
opm2-z8-s0;1206151;-9570;0;5;3918;5;3923;39.33
opt1217;1206151;-20.02139;8.22549;1;2;0;2;100
osorio-cta;1206151;0;3.5e-05;1;63;0;63;100
p0201;1206151;6875;20;1;1;0;1;100
p100x588b;1206151;58977;0;2;1;0;1;23.18
p200x1188c;1206151;15747;0;2;2;0;2;4.44
p2756;1206151;2718;2.345553;2;6;0;6;100
p500x2988;1206151;72594;0;2;32;0;32;1.06
p500x2988c;1206151;17212;0;2;28;0;28;13.13
p500x2988d;1206151;6;0;2;25;0;25;0
p6b;1206151;-52;0;3;41;0;41;17.46
p80x400b;1206151;45896;0;2;1;0;1;15.7
pb-fit2d;1206151;-22372.476239;842.898884;1;8411;12;8423;100
pb-gfrd-pnc;1206151;8316.011268;30.700616;1;135;1;136;100
pb-grow22;1206151;-449681.200587;122.632175;1;428;1;429;100
pb-market-split8-70-4;1206151;0;2.197219;1;0;0;0;100
pb-simp-nonunif;1206151;6;513.5;2;3687;48;3735;100
peg-solitaire-a3;1206151;1;289.311002;1;347;0;347;100
pg;1206151;-11098.657382;17.215049;2;4;0;4;100
pg5_34;1206151;-16012.248077;18.476238;2;6;0;6;100
physiciansched3-3;1206151;2432694.766159;1299.771515;17;59534;115;59649;100
physiciansched3-4;1206151;1124678.224456;1152.371387;12;34034;71;34105;100
physiciansched5-3;1206151;5180;1064.20702;3;1320;3;1323;100
physiciansched6-1;1206151;7500;756.571528;2;706;11;717;100
physiciansched6-2;1206151;43012.5;757.225;2;590;10;600;100
pigeon-08;1206151;-8000;8.25974;1;1;0;1;100
pigeon-10;1206151;-10000;13.559596;1;3;0;3;100
pigeon-11;1206151;-11000;16.690909;1;3;0;3;100
pigeon-12;1206151;-12000;21.818182;1;4;0;4;100
pigeon-13;1206151;-13000;24;1;4;0;4;100
pigeon-16;1206151;-16000;74.018182;1;6;0;6;100
pigeon-19;1206151;-19000;59.036364;1;33;0;33;100
pigeon-20;1206151;-20000;62.509091;1;33;0;33;100
piperout-03;1206151;68814.99759;435.327133;6;364;2;366;100
piperout-08;1206151;99128.924471;558.342366;32;411;15;426;100
piperout-27;1206151;6970;1154.464464;12;495;6;501;100
piperout-d20;1206151;25533.842105;676.796097;2;1082;2;1084;100
piperout-d27;1206151;7083.116279;1022.542306;2;1447;2;1449;100
pk1;1206151;0;2.794444;1;0;0;0;100
polygonpack3-15;1206151;-96519350.40932;30.691342;3;1450;6;1456;100
polygonpack4-10;1206151;-93676953.4701;20.42385;3;520;2;522;100
polygonpack4-15;1206151;-114052801.79086;40.321265;3;1446;6;1452;100
polygonpack4-7;1206151;-75324958.8742;9.351219;3;269;1;270;100
polygonpack5-15;1206151;-42382234.50354;24.151449;3;1670;6;1676;100
pp08a;1206151;15000;0;2;0;0;0;100
pp08aCUTS;1206151;16630.402442;0;2;2;0;2;100
probportfolio;1206151;5;15.184084;2;3;0;3;100
prod1;1206151;-100;6.72495;2;1;0;1;100
prod2;1206151;-100;4.433874;2;1;0;1;100
proteindesign121hz512p19;1206151;3197.772133;67.38213;1;17495;133;17628;100
proteindesign121hz512p9;1206151;1423.904449;61.920249;1;736;7;743;100
proteindesign121pgb11p9;1206151;1173.710433;49.777201;1;554;6;560;100
proteindesign122trx11p8;1206151;1720.461105;46.268597;1;514;6;520;100
protfold;1206151;0;35;2;16;0;16;100
pw-myciel4;1206151;0;65.596829;6;35;0;35;100
pythago7824;1206151;0;580.777778;6;736;2;738;100
pythago7825;1206151;0;586.777778;8;899;3;902;100
qap10;1206151;332.566228;55;1;356;0;356;100
qiu;1206151;1805.177143;0;2;4;0;4;100
qnet1;1206151;98035.87;7.221868;2;15;0;15;100
qnet1_o;1206151;96705.12;0;2;8;0;8;100
queens-30;1206151;-29;0;3;189;1;190;27.5
r4l4-02-tree-bounds-50;1206151;510876207;651.016667;2;55;0;55;100
r50x360;1206151;2016;0;2;1;0;1;21.96
r80x800;1206151;5520;0;2;1;0;1;3.53
radiationm18-12-05;1206151;17554.5;196.038066;1;198;1;199;100
radiationm40-10-02;1206151;155306.7;933.533;1;1118;6;1124;100
rail01;1206151;-92.0873;2555.823708;1;10258;5;10263;100
rail02;1206151;-206.6102;3001.898333;1;125323;12;125335;100
rail03;1206151;-920.273762;12426.061971;1;166602;32;166634;100
rail507;1206151;215;0;3;664;13;677;23.56
railway_8_1_0;1206151;397;64.534158;3;10;0;10;100
ramos3;1206151;377;0;3;1400;1;1401;96.35
ran12x21;1206151;4080;0;2;0;0;0;11.35
ran13x13;1206151;3521;0;2;0;0;0;8.27
ran14x18-disj-8;1206151;12451.012696;0;2;21;0;21;100
ran14x18;1206151;4265;0;2;0;0;0;14.9
ran16x16;1206151;4333;0;2;1;0;1;13.34
rd-rplusc-21;1206151;100;4.122769;1;496;1;497;100
reblock115;1206151;-39365983.337347;271.565472;1;192;0;192;100
reblock166;1206151;-886882876.965829;382.279623;1;497;0;497;100
reblock354;1206151;-39640995.765204;569.832903;3;987;1;988;100
reblock420;1206151;-886535897.522137;986.979676;1;2507;0;2507;100
reblock67;1206151;-39339910.923037;159.950504;1;53;0;53;100
rfds-4-days;1206151;-1158940.978167;54.113757;1;63413;26;63439;100
rlp1;1206151;13.244444;9.961905;1;1;0;1;100
rmatr100-p10;1206151;360.593308;9.692735;1;177;0;177;100
rmatr100-p5;1206151;762.040054;5;1;450;0;450;100
rmatr200-p10;1206151;1550.620783;10;1;11078;0;11078;100
rmatr200-p20;1206151;688.357943;19.982266;1;4053;0;4053;100
rmatr200-p5;1206151;3283.653831;5;1;11666;0;11666;100
rmine10;1206151;-1926.821009;886.351115;2;3890;1;3891;100
rmine11;1206151;-2506.77351;1261.593346;9;11065;12;11077;100
rmine13;1206151;-3504.619914;1108.274293;2;41332;6;41338;100
rmine14;1206151;-4308.553472;2211.904816;7;96715;29;96744;100
rmine15;1206151;-5041.323514;4256.942532;5;177173;24;177197;100
rmine6;1206151;-435.437835;43.92694;14;121;2;123;100
rocI-3-11;1206151;-111086.671772;559.283036;1;47;0;47;100
rocI-4-11;1206151;-11111086.671772;810.679039;1;69;0;69;100
rocII-10-11;1206151;-11.974865;306.103805;1;572;2;574;100
rocII-4-11;1206151;-11.937162;82.5;1;145;1;146;100
rocII-5-11;1206151;-11.94973;122.235744;1;178;1;179;100
rocII-7-11;1206151;-11.964093;207.33219;1;315;1;316;100
rocII-8-11;1206151;-11.968581;244.702313;1;456;2;458;100
rocII-9-11;1206151;-11.972072;276.465408;1;482;2;484;100
rococoB10-011000;1206151;8350.199468;49.840978;1;156;0;156;100
rococoC10-001000;1206151;7515.271029;14.886765;1;58;0;58;100
rococoC11-010100;1206151;8773.206543;49.89581;1;158;0;158;100
rococoC11-011100;1206151;9024.205406;56.60339;1;125;0;125;100
rococoC12-010001;1206151;26787.292147;50.829414;1;213;1;214;100
rococoC12-111000;1206151;27337.357381;53.501346;1;272;0;272;100
roi2alpha3n4;1206151;-80.526722;7.807845;2;706;9;715;100
roi5alpha10n8;1206151;-87.787142;16;2;2145;29;2174;100
roll3000;1206151;11097.127677;46.77651;3;36;0;36;100
rout;1206151;981.864286;9.898077;1;2;0;2;100
rpp22falsei;1206151;0;0;1;48;0;48;0
rvb-sub;1206151;11.206514;4.571429;1;713;5;718;100
s100;1206151;-0.171097;43.263533;1;25673;18;25691;100
s1234;1206151;0.361925;1.578294;6;1760;2;1762;100
s250r10;1206151;-0.166732;112.777088;2;10330;25;10355;100
s55;1206151;-22.151773;0;1;1680;3;1683;0
s82;1206151;-33.833613;638.111555;2;198057;167;198224;100
satellites1-25;1206151;-20;46.054099;1;131;0;131;100
satellites2-25;1206151;-30;232.549845;1;4555;2;4557;100
satellites2-40;1206151;-30;128.145498;1;15351;2;15353;100
satellites2-60-fs;1206151;-30;502.252135;1;2478;1;2479;100
satellites2-60;1206151;-30;313.609113;1;16602;3;16605;100
satellites3-25;1206151;-39;981.495523;1;201712;5;201717;100
satellites3-40-fs;1206151;-39;956.482639;1;29091;4;29095;100
satellites3-40;1206151;-39;963.650088;1;206691;6;206697;100
savsched1;1206151;22586.49862;0;2;118205;40;118245;100
scpj4scip;1206151;213;0;3;1244;20;1264;65.12
scpk4;1206151;599;0;3;2649;22;2671;86.6
scpl4;1206151;437;0;3;4702;42;4744;66.16
scpm1;1206151;905;0;3;43918;123;44041;61.32
scpn2;1206151;764;0;3;71132;255;71387;43.07
sct1;1206151;-218.139003;91.32546;1;1403;0;1403;100
sct2;1206151;-231.116964;15.708827;1;64;0;64;100
sct31;1206151;-31.962662;31.547827;1;168;0;168;100
sct32;1206151;-62.990833;53.144038;1;685;0;685;100
sct5;1206151;-228.176552;31.924007;2;291;2;293;100
seqsolve1;1206151;4376.282987;371.073706;19;4067;164;4231;100
seqsolve2short4288;1206151;4.45;440.788269;4;2794;42;2836;100
seqsolve3short4288excess384;1206151;-46401.234768;425.509375;7;12881;62;12943;100
set1ch;1206151;110241.5;0;2;1;0;1;100
set3-09;1206151;1263.077974;49.748593;3;45;0;45;100
set3-10;1206151;788.890655;50.61299;3;38;0;38;100
set3-15;1206151;8364.040745;53.876403;3;40;0;40;100
set3-16;1206151;9916.808562;58.149187;3;45;0;45;100
set3-20;1206151;10347.381087;53.849605;3;42;0;42;100
seymour-disj-10;1206151;326.000001;2e-06;3;1658;1;1659;100
seymour;1206151;460;0;3;208;0;208;8.75
seymour1;1206151;426.819841;0;3;197;0;197;3.91
shiftreg1-4;1206151;131.656032;300.178571;1;60;0;60;100
shiftreg2-7;1206151;206.733052;275.753282;1;69;0;69;100
shiftreg5-1;1206151;520.839888;632.617991;1;320;0;320;100
shipsched;1206151;0;2.147365;5;130;2;132;100
shipschedule3shipsi;1206151;-265650;0;1;38;0;38;0
shipschedule6shipsmixi;1206151;-301650;0;1;62;0;62;0
shipschedule8shipsmixuci;1206151;-401100;0;1;67;1;68;0
shs1014;1206151;22137.410363;350.541667;1;175195;18;175213;100
shs1042;1206151;9455.525826;684.883411;1;66162;19;66181;100
siena1;1206151;10163179.229002;146.859338;1;1555;1;1556;100
sing11;1206151;18640171.224643;331.879469;1;7898;7;7905;100
sing161;1206151;19071259.113927;996.464534;1;63830;36;63866;100
sing17;1206151;35483848.876514;554.751047;1;30388;21;30409;100
sing2;1206151;17150914.71694;252.506822;1;1696;1;1697;100
sing245;1206151;25024015.754083;519.079791;1;12097;11;12108;100
sing326;1206151;7717674.801189;203.886687;1;2562;2;2564;100
sing359;1206151;22534478.962498;1259.613224;1;80606;30;80636;100
sing44;1206151;8102513.2194;177.330369;1;2939;2;2941;100
sing5;1206151;18418516.013137;272.410096;1;3584;6;3590;100
snip10x10-35r1budget17;1206151;30;2.533333;1;440;0;440;100
snp-02-004-104;1206151;548044802.97509;10.217187;2;4135;0;4135;100
snp-04-052-052;1206151;728196432.049806;735.582559;2;3530;2;3532;100
snp-06-004-052;1206151;1787138156.58097;33.734354;2;6167;1;6168;100
snp-10-004-052;1206151;5842625068.20526;48.106063;2;14552;2;14554;100
snp-10-052-052;1206151;5842626434.04626;1694.316668;2;15930;4;15934;100
sorrell3;1206151;-11;0;3;691;8;699;31.25
sorrell4;1206151;-16;0;3;2930;30;2960;33.33
sorrell7;1206151;-150;0;3;367;4;371;23.47
sorrell8;1206151;-260;0;3;77;1;78;25.71
sp150x300d;1206151;71;0;2;0;0;0;2.9
sp97ar;1206151;859516425.84;0;4;520;6;526;30.09
sp97ic;1206151;639243399.84;0;3;363;4;367;49.47
sp98ar;1206151;657784123.961774;1.59976;4;904;8;912;100
sp98ic;1206151;624669411.84;0;4;368;6;374;39.08
sp98ir;1206151;304993983.714031;8.100839;4;66;1;67;100
splice1k1;1206151;-1646.777979;8.512635;1;18896;7;18903;100
splice1k1i;1206151;-1654;0;1;196;6;202;0
square23;1206151;8.333333;12.444444;1;144;3;147;100
square31;1206151;8.5;13.75;1;794;13;807;100
square37;1206151;8.666667;15;1;2374;31;2405;100
square41;1206151;8.839612;15.068891;1;3566;44;3610;100
square47;1206151;8.755814;15.976744;1;6479;88;6567;100
stoch-vrpvrp-s5v2c8vrp-v2c8i;1206151;0;119.181818;1;33;0;33;100
stockholm;1206151;173;0;2;470;0;470;38.4
stp3d;1206151;604.886283;537.229946;2;24234;18;24252;100
sts405;1206151;357;0;3;556;2;558;0
sts729;1206151;665;0;3;3426;7;3433;0
supportcase1;1206151;20078;0.020624;2;301;5;306;100
supportcase10;1206151;3.383924;1850.997936;1;10074;3;10077;100
supportcase11;1206151;-25.979452;762069;1;288978;478;289456;100
supportcase12;1206151;-7609.533054;55.569104;1;1657;2;1659;100
supportcase14;1206151;272;9.894737;1;4;0;4;100
supportcase16;1206151;272;9;1;2;0;2;100
supportcase17;1206151;0;88.929601;2;9;0;9;100
supportcase18;1206151;87;9.141806;2;51;1;52;100
supportcase19;1206151;12677206;370.390975;1;26872;65;26937;100
supportcase2;1206151;0;7.75;1;9287;49;9336;100
supportcase20;1206151;2442.144012;4.88286;1;20;0;20;100
supportcase23;1206151;-12952;674.436182;1;1510;0;1510;100
supportcase25;1206151;0.036932;10.829622;1;97;0;97;100
supportcase26;1206151;1288.102161;0.009948;2;2;0;2;100
supportcase27i;1206151;0;0.028235;1;2;0;2;100
supportcase3;1206151;0;754.600046;3;219;1;220;100
supportcase30;1206151;0;102.85702;1;61;0;61;100
supportcase31;1206151;-1120655.076;0;3;1848;76;1924;69.88
supportcase33;1206151;-468.46299;67.367519;2;450;3;453;100
supportcase34;1206151;72.664116;328.063419;1;1207;2;1209;100
supportcase35;1206151;77847.333333;96;2;118;0;118;100
supportcase37;1206151;-5865.764096;28.093523;2;822;0;822;100
supportcase39;1206151;-1062330.369524;22.808785;5;103;7;110;100
supportcase4;1206151;0;537.153071;3;164;0;164;100
supportcase40;1206151;22536.483379;19;1;254;0;254;100
supportcase41;1206151;28;24.340373;5;299;1;300;100
supportcase42;1206151;7.343539;48.081295;1;1809;2;1811;100
supportcase43;1206151;0;48.147044;2;51888;3;51891;100
supportcase6;1206151;45090.732163;30.239669;1;1391;7;1398;100
supportcase7;1206151;-2396.218213;53.14731;2;1892;0;1892;100
swath;1206151;334.496858;2.2;1;42;0;42;100
swath1;1206151;334.496858;0.6;1;35;0;35;100
swath2;1206151;334.496858;0.7;1;34;0;34;100
swath3;1206151;334.496858;0.8;1;33;0;33;100
t1717;1206151;134531.021428;79.098998;1;289;4;293;100
t1722;1206151;98815.407611;52.399108;1;151;2;153;100
ta1-UUM;1206151;3693674.556772;4.190418;1;4;0;4;100
ta2-UUE;1206151;41427354.755773;0.680983;2;163;0;163;100
tanglegram1;1206151;0;146;1;251;2;253;100
tanglegram2;1206151;0;74;1;39;0;39;100
tanglegram4;1206151;0;214;1;794;3;797;100
tanglegram6;1206151;0;100;1;61;0;61;100
tbfp-bigm;1206151;-178.153988;30;1;269;0;269;100
tbfp-network;1206151;23.261535;31;1;899;3;902;100
Test3;1206151;2669532.692462;22.368722;2;255;3;258;100
thor50dday;1206151;204179;0;2;218;3;221;100
timtab1;1206151;1234325.333333;18.45;2;0;0;0;100
timtab1CUTS;1206151;613590.095426;35.885811;2;3;0;3;100
timtab2;1206151;1487304.333333;29.783333;2;1;0;1;100
tokyometro;1206151;11100;251.050363;2;77;0;77;100
toll-like;1206151;0;339.5;1;36;0;36;100
tpl-tub-ss16;1206151;8052373.477492;2148.906605;3;90392;281;90673;100
tpl-tub-ws1617;1206151;10498468.058836;2262.455897;3;121400;430;121830;100
tr12-30;1206151;188435.464884;3.580258;2;2;0;2;100
traininstance2;1206151;0;641.708827;2;58;0;58;100
traininstance6;1206151;0;381.122112;2;43;0;43;100
transportmoment;1206151;-70929535815.38;783.890174;2;202;0;202;100
trento1;1206151;5182758.848056;76.181959;1;551;0;551;100
triptim1;1206151;22.868087;2090.375;1;10391;3;10394;100
triptim2;1206151;10.866359;807.547954;1;10651;4;10655;100
triptim3;1206151;13.511741;809.069096;1;10628;3;10631;100
triptim4;1206151;9.207022;595.626838;1;11006;3;11009;100
triptim7;1206151;2336.732602;612.910017;2;11845;6;11851;100
triptim8;1206151;2336.754853;584.347661;2;12125;6;12131;100
tw-myciel4;1206151;3.838028;125.987676;4;171;0;171;100
uc-case11;1206151;611267.013003;118.928617;1;2816;0;2816;100
uc-case3;1206151;7181.264177;95.341586;1;2115;0;2115;100
uccase10;1206151;38988.693469;403.985961;1;2803;1;2804;100
uccase12;1206151;11507.285324;38.32;1;2274;1;2275;100
uccase7;1206151;26527.789654;162.379998;1;3941;0;3941;100
uccase8;1206151;11142.163196;63.982247;1;3021;0;3021;100
uccase9;1206151;10819.582997;76.021209;1;4468;0;4468;100
uct-subprob;1206151;242;56.889019;1;41;0;41;100
umts;1206151;91618146.215272;77.667697;2;49;0;49;100
unitcal_7;1206151;19387754.848556;143.965819;2;833;0;833;100
usAbbrv-8-25_70;1206151;95;138.115058;3;35;0;35;100
usafa;1206151;11.961749;2881.373487;2;49760;161;49921;100
v150d30-2hopcds;1206151;54;0;3;123;2;125;31.71
van;1206151;1.72352;5.404444;1;2364;0;2364;100
var-smallemery-m6j6;1206151;-156.056268;90.190835;2;1285;8;1293;100
vpm2;1206151;13.372866;5.698001;2;1;0;1;100
vpphard;1206151;0;125.275;1;226;3;229;100
vpphard2;1206151;0;224.687229;1;675;13;688;100
wachplan;1206151;-9;69.499445;1;45;0;45;100
wnq-n100-mw99-14;1206151;198.078947;81.026316;3;5070;29;5099;100
xmas10-2;1206151;-548.904684;180.189643;1;226;0;226;100
xmas10;1206151;-449.397905;132.337672;7;194;0;194;100
z26;1206151;-981;0;3;2740;46;2786;17.35
zeil;1206151;813.510308;818.357568;2;86679;13;86692;100
zib54-UUE;1206151;19164366;0;2;49;0;49;85.45
